prompt	ground_truth	candidate
run opposite right twice after walk around right thrice ->	RIGHT WALK RIGHT WALK RIGHT WALK RIGHT WALK RIGHT WALK RIGHT WALK RIGHT WALK RIGHT WALK RIGHT WALK RIGHT WALK RIGHT WALK RIGHT WALK RIGHT RIGHT RUN RIGHT RIGHT RUN	 turn right walk turn right walk turn right walk turn right walk turn right walk turn right walk turn right walk turn right walk turn right turn right run turn right turn right run
jump around left after look around right twice ->	RIGHT LOOK RIGHT LOOK RIGHT LOOK RIGHT LOOK RIGHT LOOK RIGHT LOOK RIGHT LOOK RIGHT LOOK LEFT JUMP LEFT JUMP LEFT JUMP LEFT JUMP	 turn right look turn right look turn right look turn right look turn right look turn right look turn right look turn right look turn left jump turn left jump turn left jump turn left jump
run twice and walk around right thrice ->	RUN RUN RIGHT WALK RIGHT WALK RIGHT WALK RIGHT WALK RIGHT WALK RIGHT WALK RIGHT WALK RIGHT WALK RIGHT WALK RIGHT WALK RIGHT WALK RIGHT WALK	 run run turn right walk turn right walk turn right walk turn right walk turn right walk turn right walk turn right walk turn right walk
jump opposite left twice and walk around left thrice ->	LEFT LEFT JUMP LEFT LEFT JUMP LEFT WALK LEFT WALK LEFT WALK LEFT WALK LEFT WALK LEFT WALK LEFT WALK LEFT WALK LEFT WALK LEFT WALK LEFT WALK LEFT WALK	 turn left turn left jump turn left turn left jump turn left walk turn left walk turn left walk turn left walk turn left walk turn left walk turn left walk turn left walk turn left walk
turn opposite right thrice and run around left thrice ->	RIGHT RIGHT RIGHT RIGHT RIGHT RIGHT LEFT RUN LEFT RUN LEFT RUN LEFT RUN LEFT RUN LEFT RUN LEFT RUN LEFT RUN LEFT RUN LEFT RUN LEFT RUN LEFT RUN	 turn right turn right turn right turn right turn right turn right turn left run turn left run turn left run turn left run turn left run turn left run turn left run turn left run turn left run
look around right and look around right thrice ->	RIGHT LOOK RIGHT LOOK RIGHT LOOK RIGHT LOOK RIGHT LOOK RIGHT LOOK RIGHT LOOK RIGHT LOOK RIGHT LOOK RIGHT LOOK RIGHT LOOK RIGHT LOOK RIGHT LOOK RIGHT LOOK RIGHT LOOK RIGHT LOOK	 turn right look turn right look turn right look turn right look turn right look turn right look turn right look turn right look turn right look turn right look turn right look turn right look
turn around right after run around left thrice ->	LEFT RUN LEFT RUN LEFT RUN LEFT RUN LEFT RUN LEFT RUN LEFT RUN LEFT RUN LEFT RUN LEFT RUN LEFT RUN LEFT RUN RIGHT RIGHT RIGHT RIGHT	 turn left run turn left run turn left run turn left run turn left run turn left run turn left run turn left run turn left run turn right turn right turn right turn right
jump around right twice and turn around right thrice ->	RIGHT JUMP RIGHT JUMP RIGHT JUMP RIGHT JUMP RIGHT JUMP RIGHT JUMP RIGHT JUMP RIGHT JUMP RIGHT RIGHT RIGHT RIGHT RIGHT RIGHT RIGHT RIGHT RIGHT RIGHT RIGHT RIGHT	 turn right jump turn right jump turn right jump turn right jump turn right jump turn right jump turn right jump turn right jump turn right jump turn right jump turn right turn right turn right turn right turn right turn right turn right turn right turn right turn right
jump left after walk around left thrice ->	LEFT WALK LEFT WALK LEFT WALK LEFT WALK LEFT WALK LEFT WALK LEFT WALK LEFT WALK LEFT WALK LEFT WALK LEFT WALK LEFT WALK LEFT JUMP	 turn left walk turn left walk turn left walk turn left walk turn left walk turn left walk turn left walk turn left walk turn left walk turn left walk
run around right twice and jump around right twice ->	RIGHT RUN RIGHT RUN RIGHT RUN RIGHT RUN RIGHT RUN RIGHT RUN RIGHT RUN RIGHT RUN RIGHT JUMP RIGHT JUMP RIGHT JUMP RIGHT JUMP RIGHT JUMP RIGHT JUMP RIGHT JUMP RIGHT JUMP	 turn right run turn right run turn right run turn right run turn right run turn right run turn right run turn right run turn right run turn right jump turn right jump turn right jump turn right jump
run around right twice and run opposite right thrice ->	RIGHT RUN RIGHT RUN RIGHT RUN RIGHT RUN RIGHT RUN RIGHT RUN RIGHT RUN RIGHT RUN RIGHT RIGHT RUN RIGHT RIGHT RUN RIGHT RIGHT RUN	 turn right run turn right run turn right run turn right run turn right run turn right run turn right run turn right turn right run turn right turn right run turn right turn right run
walk around right thrice after jump left twice ->	LEFT JUMP LEFT JUMP RIGHT WALK RIGHT WALK RIGHT WALK RIGHT WALK RIGHT WALK RIGHT WALK RIGHT WALK RIGHT WALK RIGHT WALK RIGHT WALK RIGHT WALK RIGHT WALK	 turn left jump turn left jump turn right walk turn right walk turn right walk turn right walk turn right walk turn right walk turn right walk turn right walk turn right walk turn right walk
walk opposite left after run around left thrice ->	LEFT RUN LEFT RUN LEFT RUN LEFT RUN LEFT RUN LEFT RUN LEFT RUN LEFT RUN LEFT RUN LEFT RUN LEFT RUN LEFT RUN LEFT LEFT WALK	 turn left run turn left run turn left run turn left run turn left run turn left run turn left run turn left run turn left run turn left run turn left run
look around left thrice after look twice ->	LOOK LOOK LEFT LOOK LEFT LOOK LEFT LOOK LEFT LOOK LEFT LOOK LEFT LOOK LEFT LOOK LEFT LOOK LEFT LOOK LEFT LOOK LEFT LOOK LEFT LOOK	 look look turn left look turn left look turn left look turn left look turn left look turn left look turn left look turn left look turn left look turn left look turn left look
jump opposite right thrice after run around left thrice ->	LEFT RUN LEFT RUN LEFT RUN LEFT RUN LEFT RUN LEFT RUN LEFT RUN LEFT RUN LEFT RUN LEFT RUN LEFT RUN LEFT RUN RIGHT RIGHT JUMP RIGHT RIGHT JUMP RIGHT RIGHT JUMP	 turn left run turn left run turn left run turn left run turn left run turn left run turn left run turn left run turn left run turn left run turn right turn right jump turn right turn right jump turn right turn right jump
look around left thrice and run around left ->	LEFT LOOK LEFT LOOK LEFT LOOK LEFT LOOK LEFT LOOK LEFT LOOK LEFT LOOK LEFT LOOK LEFT LOOK LEFT LOOK LEFT LOOK LEFT LOOK LEFT RUN LEFT RUN LEFT RUN LEFT RUN	 turn left look turn left look turn left look turn left look turn left look turn left look turn left look turn left look turn left look turn left run turn left run turn left run turn left run
look around right twice and turn around left thrice ->	RIGHT LOOK RIGHT LOOK RIGHT LOOK RIGHT LOOK RIGHT LOOK RIGHT LOOK RIGHT LOOK RIGHT LOOK LEFT LEFT LEFT LEFT LEFT LEFT LEFT LEFT LEFT LEFT LEFT LEFT	 turn right look turn right look turn right look turn right look turn right look turn right look turn right look turn right look turn left turn left turn left turn left turn left turn left turn left turn left turn left
look around left after jump around right twice ->	RIGHT JUMP RIGHT JUMP RIGHT JUMP RIGHT JUMP RIGHT JUMP RIGHT JUMP RIGHT JUMP RIGHT JUMP LEFT LOOK LEFT LOOK LEFT LOOK LEFT LOOK	 turn right jump turn right jump turn right jump turn right jump turn right jump turn right jump turn right jump turn left look turn left look turn left look turn left look
jump around right thrice after walk opposite left thrice ->	LEFT LEFT WALK LEFT LEFT WALK LEFT LEFT WALK RIGHT JUMP RIGHT JUMP RIGHT JUMP RIGHT JUMP RIGHT JUMP RIGHT JUMP RIGHT JUMP RIGHT JUMP RIGHT JUMP RIGHT JUMP RIGHT JUMP RIGHT JUMP	 turn left turn left walk turn left turn left walk turn left turn left walk turn right jump turn right jump turn right jump turn right jump turn right jump turn right jump turn right jump turn right jump turn right jump
walk around left thrice and jump opposite right ->	LEFT WALK LEFT WALK LEFT WALK LEFT WALK LEFT WALK LEFT WALK LEFT WALK LEFT WALK LEFT WALK LEFT WALK LEFT WALK LEFT WALK RIGHT RIGHT JUMP	 turn left walk turn left walk turn left walk turn left walk turn left walk turn left walk turn left walk turn left walk turn left walk turn right turn right jump
jump left thrice and run around right thrice ->	LEFT JUMP LEFT JUMP LEFT JUMP RIGHT RUN RIGHT RUN RIGHT RUN RIGHT RUN RIGHT RUN RIGHT RUN RIGHT RUN RIGHT RUN RIGHT RUN RIGHT RUN RIGHT RUN RIGHT RUN	 turn left jump turn left jump turn left jump turn right run turn right run turn right run turn right run turn right run turn right run turn right run turn right run turn right run
look left thrice and run around left thrice ->	LEFT LOOK LEFT LOOK LEFT LOOK LEFT RUN LEFT RUN LEFT RUN LEFT RUN LEFT RUN LEFT RUN LEFT RUN LEFT RUN LEFT RUN LEFT RUN LEFT RUN LEFT RUN	 turn left look turn left look turn left look turn left run turn left run turn left run turn left run turn left run turn left run turn left run turn left run turn left run
walk around left thrice and walk twice ->	LEFT WALK LEFT WALK LEFT WALK LEFT WALK LEFT WALK LEFT WALK LEFT WALK LEFT WALK LEFT WALK LEFT WALK LEFT WALK LEFT WALK WALK WALK	 turn left walk turn left walk turn left walk turn left walk turn left walk turn left walk turn left walk turn left walk turn left walk walk walk
run around right twice after turn around left twice ->	LEFT LEFT LEFT LEFT LEFT LEFT LEFT LEFT RIGHT RUN RIGHT RUN RIGHT RUN RIGHT RUN RIGHT RUN RIGHT RUN RIGHT RUN RIGHT RUN	 turn left turn left turn left turn left turn left turn left turn left turn left turn left turn left turn right run turn right run turn right run turn right run turn right run turn right run turn right run turn right run turn right run
turn around left after jump around right thrice ->	RIGHT JUMP RIGHT JUMP RIGHT JUMP RIGHT JUMP RIGHT JUMP RIGHT JUMP RIGHT JUMP RIGHT JUMP RIGHT JUMP RIGHT JUMP RIGHT JUMP RIGHT JUMP LEFT LEFT LEFT LEFT	 turn right jump turn right jump turn right jump turn right jump turn right jump turn right jump turn right jump turn right jump turn left turn left turn left turn left turn left
run around left thrice and look right ->	LEFT RUN LEFT RUN LEFT RUN LEFT RUN LEFT RUN LEFT RUN LEFT RUN LEFT RUN LEFT RUN LEFT RUN LEFT RUN LEFT RUN RIGHT LOOK	 turn left run turn left run turn left run turn left run turn left run turn left run turn left run turn left run turn left run turn right look
look around right thrice and walk around right thrice ->	RIGHT LOOK RIGHT LOOK RIGHT LOOK RIGHT LOOK RIGHT LOOK RIGHT LOOK RIGHT LOOK RIGHT LOOK RIGHT LOOK RIGHT LOOK RIGHT LOOK RIGHT LOOK RIGHT WALK RIGHT WALK RIGHT WALK RIGHT WALK RIGHT WALK RIGHT WALK RIGHT WALK RIGHT WALK RIGHT WALK RIGHT WALK RIGHT WALK RIGHT WALK	 turn right look turn right look turn right look turn right look turn right look turn right look turn right look turn right look turn right look turn right walk turn right walk turn right walk turn right walk turn right walk turn right walk turn right walk
run around right thrice after look around right ->	RIGHT LOOK RIGHT LOOK RIGHT LOOK RIGHT LOOK RIGHT RUN RIGHT RUN RIGHT RUN RIGHT RUN RIGHT RUN RIGHT RUN RIGHT RUN RIGHT RUN RIGHT RUN RIGHT RUN RIGHT RUN RIGHT RUN	 turn right look turn right look turn right look turn right look turn right run turn right run turn right run turn right run turn right run turn right run turn right run turn right run turn right run
jump around right and jump around right twice ->	RIGHT JUMP RIGHT JUMP RIGHT JUMP RIGHT JUMP RIGHT JUMP RIGHT JUMP RIGHT JUMP RIGHT JUMP RIGHT JUMP RIGHT JUMP RIGHT JUMP RIGHT JUMP	 turn right jump turn right jump turn right jump turn right jump turn right jump turn right jump turn right jump turn right jump turn right jump turn right jump turn right jump turn right jump turn right jump
jump twice after walk around left thrice ->	LEFT WALK LEFT WALK LEFT WALK LEFT WALK LEFT WALK LEFT WALK LEFT WALK LEFT WALK LEFT WALK LEFT WALK LEFT WALK LEFT WALK JUMP JUMP	 turn left walk turn left walk turn left walk turn left walk turn left walk turn left walk turn left walk turn left walk turn left walk jump jump
jump left twice and run around left thrice ->	LEFT JUMP LEFT JUMP LEFT RUN LEFT RUN LEFT RUN LEFT RUN LEFT RUN LEFT RUN LEFT RUN LEFT RUN LEFT RUN LEFT RUN LEFT RUN LEFT RUN	 turn left jump turn left jump turn left run turn left run turn left run turn left run turn left run turn left run turn left run turn left run turn left run
walk around right thrice and run around left thrice ->	RIGHT WALK RIGHT WALK RIGHT WALK RIGHT WALK RIGHT WALK RIGHT WALK RIGHT WALK RIGHT WALK RIGHT WALK RIGHT WALK RIGHT WALK RIGHT WALK LEFT RUN LEFT RUN LEFT RUN LEFT RUN LEFT RUN LEFT RUN LEFT RUN LEFT RUN LEFT RUN LEFT RUN LEFT RUN LEFT RUN	 turn right walk turn right walk turn right walk turn right walk turn right walk turn right walk turn right walk turn right walk turn right walk turn left run turn left run turn left run turn left run turn left run turn left run turn left run turn left run
turn around right thrice and walk around right twice ->	RIGHT RIGHT RIGHT RIGHT RIGHT RIGHT RIGHT RIGHT RIGHT RIGHT RIGHT RIGHT RIGHT WALK RIGHT WALK RIGHT WALK RIGHT WALK RIGHT WALK RIGHT WALK RIGHT WALK RIGHT WALK	 turn right turn right turn right turn right turn right turn right turn right turn right turn right turn right turn right turn right turn right walk turn right walk turn right walk turn right walk
run around right thrice and jump right ->	RIGHT RUN RIGHT RUN RIGHT RUN RIGHT RUN RIGHT RUN RIGHT RUN RIGHT RUN RIGHT RUN RIGHT RUN RIGHT RUN RIGHT RUN RIGHT RUN RIGHT JUMP	 turn right run turn right run turn right run turn right run turn right run turn right run turn right run turn right run turn right run turn right jump
walk opposite right thrice after walk around left thrice ->	LEFT WALK LEFT WALK LEFT WALK LEFT WALK LEFT WALK LEFT WALK LEFT WALK LEFT WALK LEFT WALK LEFT WALK LEFT WALK LEFT WALK RIGHT RIGHT WALK RIGHT RIGHT WALK RIGHT RIGHT WALK	 turn left walk turn left walk turn left walk turn left walk turn left walk turn left walk turn left walk turn left walk turn right turn right walk turn right turn right walk turn right turn right walk
walk after look around left thrice ->	LEFT LOOK LEFT LOOK LEFT LOOK LEFT LOOK LEFT LOOK LEFT LOOK LEFT LOOK LEFT LOOK LEFT LOOK LEFT LOOK LEFT LOOK LEFT LOOK WALK	 turn left look turn left look turn left look turn left look turn left look turn left look turn left look turn left look turn left look walk
look around left thrice after walk ->	WALK LEFT LOOK LEFT LOOK LEFT LOOK LEFT LOOK LEFT LOOK LEFT LOOK LEFT LOOK LEFT LOOK LEFT LOOK LEFT LOOK LEFT LOOK LEFT LOOK	 walk turn left look turn left look turn left look turn left look turn left look turn left look turn left look turn left look turn left look turn left look
look around right thrice after jump right thrice ->	RIGHT JUMP RIGHT JUMP RIGHT JUMP RIGHT LOOK RIGHT LOOK RIGHT LOOK RIGHT LOOK RIGHT LOOK RIGHT LOOK RIGHT LOOK RIGHT LOOK RIGHT LOOK RIGHT LOOK RIGHT LOOK RIGHT LOOK	 turn right jump turn right jump turn right jump turn right look turn right look turn right look turn right look turn right look turn right look turn right look turn right look turn right look turn right look
run opposite left and look around left thrice ->	LEFT LEFT RUN LEFT LOOK LEFT LOOK LEFT LOOK LEFT LOOK LEFT LOOK LEFT LOOK LEFT LOOK LEFT LOOK LEFT LOOK LEFT LOOK LEFT LOOK LEFT LOOK	 turn left turn left run turn left look turn left look turn left look turn left look turn left look turn left look turn left look turn left look turn left look
walk around right thrice and jump twice ->	RIGHT WALK RIGHT WALK RIGHT WALK RIGHT WALK RIGHT WALK RIGHT WALK RIGHT WALK RIGHT WALK RIGHT WALK RIGHT WALK RIGHT WALK RIGHT WALK JUMP JUMP	 turn right walk turn right walk turn right walk turn right walk turn right walk turn right walk turn right walk turn right walk turn right walk jump jump
jump around left and walk around right thrice ->	LEFT JUMP LEFT JUMP LEFT JUMP LEFT JUMP RIGHT WALK RIGHT WALK RIGHT WALK RIGHT WALK RIGHT WALK RIGHT WALK RIGHT WALK RIGHT WALK RIGHT WALK RIGHT WALK RIGHT WALK RIGHT WALK	 turn left jump turn left jump turn left jump turn left jump turn right walk turn right walk turn right walk turn right walk turn right walk turn right walk turn right walk turn right walk
run left and look around right thrice ->	LEFT RUN RIGHT LOOK RIGHT LOOK RIGHT LOOK RIGHT LOOK RIGHT LOOK RIGHT LOOK RIGHT LOOK RIGHT LOOK RIGHT LOOK RIGHT LOOK RIGHT LOOK RIGHT LOOK	 turn left run turn right look turn right look turn right look turn right look turn right look turn right look turn right look turn right look turn right look
run right after jump around left thrice ->	LEFT JUMP LEFT JUMP LEFT JUMP LEFT JUMP LEFT JUMP LEFT JUMP LEFT JUMP LEFT JUMP LEFT JUMP LEFT JUMP LEFT JUMP LEFT JUMP RIGHT RUN	 turn left jump turn left jump turn left jump turn left jump turn left jump turn left jump turn left jump turn left jump turn left jump turn left jump
run around left and look around left thrice ->	LEFT RUN LEFT RUN LEFT RUN LEFT RUN LEFT LOOK LEFT LOOK LEFT LOOK LEFT LOOK LEFT LOOK LEFT LOOK LEFT LOOK LEFT LOOK LEFT LOOK LEFT LOOK LEFT LOOK LEFT LOOK	 turn left run turn left run turn left run turn left run turn left look turn left look turn left look turn left look turn left look turn left look turn left look turn left look
run around right thrice after jump opposite left ->	LEFT LEFT JUMP RIGHT RUN RIGHT RUN RIGHT RUN RIGHT RUN RIGHT RUN RIGHT RUN RIGHT RUN RIGHT RUN RIGHT RUN RIGHT RUN RIGHT RUN RIGHT RUN	 turn left turn left jump turn right run turn right run turn right run turn right run turn right run turn right run turn right run turn right run turn right run turn right run
run around left twice and turn around left thrice ->	LEFT RUN LEFT RUN LEFT RUN LEFT RUN LEFT RUN LEFT RUN LEFT RUN LEFT RUN LEFT LEFT LEFT LEFT LEFT LEFT LEFT LEFT LEFT LEFT LEFT LEFT	 turn left run turn left run turn left run turn left run turn left run turn left run turn left run turn left run turn left run turn left run turn left turn left turn left turn left turn left turn left turn left turn left turn left turn left turn left turn left
jump around left thrice and look right ->	LEFT JUMP LEFT JUMP LEFT JUMP LEFT JUMP LEFT JUMP LEFT JUMP LEFT JUMP LEFT JUMP LEFT JUMP LEFT JUMP LEFT JUMP LEFT JUMP RIGHT LOOK	 turn left jump turn left jump turn left jump turn left jump turn left jump turn left jump turn left jump turn left jump turn left jump turn right look
walk left twice after run around left thrice ->	LEFT RUN LEFT RUN LEFT RUN LEFT RUN LEFT RUN LEFT RUN LEFT RUN LEFT RUN LEFT RUN LEFT RUN LEFT RUN LEFT RUN LEFT WALK LEFT WALK	 turn left run turn left run turn left run turn left run turn left run turn left run turn left run turn left run turn left run turn left walk turn left walk
run right after walk around right thrice ->	RIGHT WALK RIGHT WALK RIGHT WALK RIGHT WALK RIGHT WALK RIGHT WALK RIGHT WALK RIGHT WALK RIGHT WALK RIGHT WALK RIGHT WALK RIGHT WALK RIGHT RUN	 turn right walk turn right walk turn right walk turn right walk turn right walk turn right walk turn right walk turn right walk turn right walk turn right run
walk opposite right thrice after run around right thrice ->	RIGHT RUN RIGHT RUN RIGHT RUN RIGHT RUN RIGHT RUN RIGHT RUN RIGHT RUN RIGHT RUN RIGHT RUN RIGHT RUN RIGHT RUN RIGHT RUN RIGHT RIGHT WALK RIGHT RIGHT WALK RIGHT RIGHT WALK	 turn right run turn right run turn right run turn right run turn right run turn right run turn right run turn right run turn right run turn right run turn right turn right walk turn right turn right walk turn right turn right walk
jump around left twice after walk around right ->	RIGHT WALK RIGHT WALK RIGHT WALK RIGHT WALK LEFT JUMP LEFT JUMP LEFT JUMP LEFT JUMP LEFT JUMP LEFT JUMP LEFT JUMP LEFT JUMP	 turn right walk turn right walk turn right walk turn right walk turn left jump turn left jump turn left jump turn left jump turn left jump turn left jump turn left jump turn left jump
walk around right thrice after walk opposite right ->	RIGHT RIGHT WALK RIGHT WALK RIGHT WALK RIGHT WALK RIGHT WALK RIGHT WALK RIGHT WALK RIGHT WALK RIGHT WALK RIGHT WALK RIGHT WALK RIGHT WALK RIGHT WALK	 turn right turn right walk turn right walk turn right walk turn right walk turn right walk turn right walk turn right walk turn right walk turn right walk turn right walk
turn around right twice after run around left twice ->	LEFT RUN LEFT RUN LEFT RUN LEFT RUN LEFT RUN LEFT RUN LEFT RUN LEFT RUN RIGHT RIGHT RIGHT RIGHT RIGHT RIGHT RIGHT RIGHT	 turn left run turn left run turn left run turn left run turn left run turn left run turn left run turn left run turn right turn right turn right turn right turn right turn right turn right turn right
run twice after run around left thrice ->	LEFT RUN LEFT RUN LEFT RUN LEFT RUN LEFT RUN LEFT RUN LEFT RUN LEFT RUN LEFT RUN LEFT RUN LEFT RUN LEFT RUN RUN RUN	 turn left run turn left run turn left run turn left run turn left run turn left run turn left run turn left run turn left run run run
run around left after jump around left thrice ->	LEFT JUMP LEFT JUMP LEFT JUMP LEFT JUMP LEFT JUMP LEFT JUMP LEFT JUMP LEFT JUMP LEFT JUMP LEFT JUMP LEFT JUMP LEFT JUMP LEFT RUN LEFT RUN LEFT RUN LEFT RUN	 turn left jump turn left jump turn left jump turn left jump turn left jump turn left jump turn left jump turn left jump turn left jump turn left run turn left run turn left run turn left run
jump around left thrice after turn right thrice ->	RIGHT RIGHT RIGHT LEFT JUMP LEFT JUMP LEFT JUMP LEFT JUMP LEFT JUMP LEFT JUMP LEFT JUMP LEFT JUMP LEFT JUMP LEFT JUMP LEFT JUMP LEFT JUMP	 turn right turn right turn right turn left jump turn left jump turn left jump turn left jump turn left jump turn left jump turn left jump turn left jump turn left jump
run around left and walk around left twice ->	LEFT RUN LEFT RUN LEFT RUN LEFT RUN LEFT WALK LEFT WALK LEFT WALK LEFT WALK LEFT WALK LEFT WALK LEFT WALK LEFT WALK	 turn left run turn left run turn left run turn left run turn left walk turn left walk turn left walk turn left walk turn left walk turn left walk turn left walk
walk around left thrice and jump right thrice ->	LEFT WALK LEFT WALK LEFT WALK LEFT WALK LEFT WALK LEFT WALK LEFT WALK LEFT WALK LEFT WALK LEFT WALK LEFT WALK LEFT WALK RIGHT JUMP RIGHT JUMP RIGHT JUMP	 turn left walk turn left walk turn left walk turn left walk turn left walk turn left walk turn left walk turn left walk turn left walk turn right jump turn right jump turn right jump
turn left and walk around left thrice ->	LEFT LEFT WALK LEFT WALK LEFT WALK LEFT WALK LEFT WALK LEFT WALK LEFT WALK LEFT WALK LEFT WALK LEFT WALK LEFT WALK LEFT WALK	 turn left turn left walk turn left walk turn left walk turn left walk turn left walk turn left walk turn left walk turn left walk
turn opposite right thrice after walk around right thrice ->	RIGHT WALK RIGHT WALK RIGHT WALK RIGHT WALK RIGHT WALK RIGHT WALK RIGHT WALK RIGHT WALK RIGHT WALK RIGHT WALK RIGHT WALK RIGHT WALK RIGHT RIGHT RIGHT RIGHT RIGHT RIGHT	 turn right walk turn right walk turn right walk turn right walk turn right walk turn right walk turn right walk turn right walk turn right walk turn right turn right turn right turn right turn right turn right
run around right twice and look around left twice ->	RIGHT RUN RIGHT RUN RIGHT RUN RIGHT RUN RIGHT RUN RIGHT RUN RIGHT RUN RIGHT RUN LEFT LOOK LEFT LOOK LEFT LOOK LEFT LOOK LEFT LOOK LEFT LOOK LEFT LOOK LEFT LOOK	 turn right run turn right run turn right run turn right run turn right run turn right run turn right run turn right run turn left look turn left look turn left look turn left look turn left look turn left look turn left look
run opposite right and look around left thrice ->	RIGHT RIGHT RUN LEFT LOOK LEFT LOOK LEFT LOOK LEFT LOOK LEFT LOOK LEFT LOOK LEFT LOOK LEFT LOOK LEFT LOOK LEFT LOOK LEFT LOOK LEFT LOOK	 turn right turn right run turn left look turn left look turn left look turn left look turn left look turn left look turn left look turn left look turn left look
run opposite left thrice and look around left twice ->	LEFT LEFT RUN LEFT LEFT RUN LEFT LEFT RUN LEFT LOOK LEFT LOOK LEFT LOOK LEFT LOOK LEFT LOOK LEFT LOOK LEFT LOOK LEFT LOOK	 turn left turn left run turn left turn left run turn left turn left run turn left look turn left look turn left look turn left look turn left look turn left look turn left look turn left look
walk opposite left thrice after run around right twice ->	RIGHT RUN RIGHT RUN RIGHT RUN RIGHT RUN RIGHT RUN RIGHT RUN RIGHT RUN RIGHT RUN LEFT LEFT WALK LEFT LEFT WALK LEFT LEFT WALK	 turn right run turn right run turn right run turn right run turn right run turn right run turn right run turn left turn left walk turn left turn left walk turn left turn left walk
turn opposite left and look around right thrice ->	LEFT LEFT RIGHT LOOK RIGHT LOOK RIGHT LOOK RIGHT LOOK RIGHT LOOK RIGHT LOOK RIGHT LOOK RIGHT LOOK RIGHT LOOK RIGHT LOOK RIGHT LOOK RIGHT LOOK	 turn left turn left turn right look turn right look turn right look turn right look turn right look turn right look turn right look turn right look turn right look
look around right twice after walk opposite left thrice ->	LEFT LEFT WALK LEFT LEFT WALK LEFT LEFT WALK RIGHT LOOK RIGHT LOOK RIGHT LOOK RIGHT LOOK RIGHT LOOK RIGHT LOOK RIGHT LOOK RIGHT LOOK	 turn left turn left walk turn left turn left walk turn left turn left walk turn right look turn right look turn right look turn right look turn right look turn right look turn right look turn right look
jump around right thrice after walk around right ->	RIGHT WALK RIGHT WALK RIGHT WALK RIGHT WALK RIGHT JUMP RIGHT JUMP RIGHT JUMP RIGHT JUMP RIGHT JUMP RIGHT JUMP RIGHT JUMP RIGHT JUMP RIGHT JUMP RIGHT JUMP RIGHT JUMP RIGHT JUMP	 turn right walk turn right walk turn right walk turn right jump turn right jump turn right jump turn right jump turn right jump turn right jump turn right jump turn right jump turn right jump
walk right thrice after walk around left thrice ->	LEFT WALK LEFT WALK LEFT WALK LEFT WALK LEFT WALK LEFT WALK LEFT WALK LEFT WALK LEFT WALK LEFT WALK LEFT WALK LEFT WALK RIGHT WALK RIGHT WALK RIGHT WALK	 turn left walk turn left walk turn left walk turn left walk turn left walk turn left walk turn left walk turn left walk turn left walk turn right walk turn right walk turn right walk
look around right twice and jump opposite right thrice ->	RIGHT LOOK RIGHT LOOK RIGHT LOOK RIGHT LOOK RIGHT LOOK RIGHT LOOK RIGHT LOOK RIGHT LOOK RIGHT RIGHT JUMP RIGHT RIGHT JUMP RIGHT RIGHT JUMP	 turn right look turn right look turn right look turn right look turn right look turn right look turn right look turn right turn right jump turn right turn right jump turn right turn right jump
look around left thrice after turn right twice ->	RIGHT RIGHT LEFT LOOK LEFT LOOK LEFT LOOK LEFT LOOK LEFT LOOK LEFT LOOK LEFT LOOK LEFT LOOK LEFT LOOK LEFT LOOK LEFT LOOK LEFT LOOK	 turn right turn right turn left look turn left look turn left look turn left look turn left look turn left look turn left look turn left look turn left look turn left look
jump around left thrice and walk opposite left twice ->	LEFT JUMP LEFT JUMP LEFT JUMP LEFT JUMP LEFT JUMP LEFT JUMP LEFT JUMP LEFT JUMP LEFT JUMP LEFT JUMP LEFT JUMP LEFT JUMP LEFT LEFT WALK LEFT LEFT WALK	 turn left jump turn left jump turn left jump turn left jump turn left jump turn left jump turn left jump turn left jump turn left jump turn left turn left walk turn left turn left walk
jump around left thrice after walk opposite right twice ->	RIGHT RIGHT WALK RIGHT RIGHT WALK LEFT JUMP LEFT JUMP LEFT JUMP LEFT JUMP LEFT JUMP LEFT JUMP LEFT JUMP LEFT JUMP LEFT JUMP LEFT JUMP LEFT JUMP LEFT JUMP	 turn right turn right walk turn right turn right walk turn left jump turn left jump turn left jump turn left jump turn left jump turn left jump turn left jump turn left jump turn left jump
jump around left twice after turn around right twice ->	RIGHT RIGHT RIGHT RIGHT RIGHT RIGHT RIGHT RIGHT LEFT JUMP LEFT JUMP LEFT JUMP LEFT JUMP LEFT JUMP LEFT JUMP LEFT JUMP LEFT JUMP	 turn right turn right turn right turn right turn right turn right turn right turn right turn right turn right turn left jump turn left jump turn left jump turn left jump turn left jump turn left jump turn left jump turn left jump turn left jump
run opposite left twice and walk around right thrice ->	LEFT LEFT RUN LEFT LEFT RUN RIGHT WALK RIGHT WALK RIGHT WALK RIGHT WALK RIGHT WALK RIGHT WALK RIGHT WALK RIGHT WALK RIGHT WALK RIGHT WALK RIGHT WALK RIGHT WALK	 turn left turn left run turn left turn left run turn right walk turn right walk turn right walk turn right walk turn right walk turn right walk turn right walk turn right walk turn right walk
look around right thrice after turn opposite right ->	RIGHT RIGHT RIGHT LOOK RIGHT LOOK RIGHT LOOK RIGHT LOOK RIGHT LOOK RIGHT LOOK RIGHT LOOK RIGHT LOOK RIGHT LOOK RIGHT LOOK RIGHT LOOK RIGHT LOOK	 turn right turn right turn right look turn right look turn right look turn right look turn right look turn right look turn right look turn right look turn right look
jump around right thrice after jump left thrice ->	LEFT JUMP LEFT JUMP LEFT JUMP RIGHT JUMP RIGHT JUMP RIGHT JUMP RIGHT JUMP RIGHT JUMP RIGHT JUMP RIGHT JUMP RIGHT JUMP RIGHT JUMP RIGHT JUMP RIGHT JUMP RIGHT JUMP	 turn left jump turn left jump turn left jump turn right jump turn right jump turn right jump turn right jump turn right jump turn right jump turn right jump turn right jump turn right jump
run around right thrice after jump opposite left twice ->	LEFT LEFT JUMP LEFT LEFT JUMP RIGHT RUN RIGHT RUN RIGHT RUN RIGHT RUN RIGHT RUN RIGHT RUN RIGHT RUN RIGHT RUN RIGHT RUN RIGHT RUN RIGHT RUN RIGHT RUN	 turn left turn left jump turn left turn left jump turn right run turn right run turn right run turn right run turn right run turn right run turn right run turn right run turn right run turn right run turn right run
walk opposite left after jump around left thrice ->	LEFT JUMP LEFT JUMP LEFT JUMP LEFT JUMP LEFT JUMP LEFT JUMP LEFT JUMP LEFT JUMP LEFT JUMP LEFT JUMP LEFT JUMP LEFT JUMP LEFT LEFT WALK	 turn left jump turn left jump turn left jump turn left jump turn left jump turn left jump turn left jump turn left jump turn left jump turn left jump
look around right twice and look opposite left thrice ->	RIGHT LOOK RIGHT LOOK RIGHT LOOK RIGHT LOOK RIGHT LOOK RIGHT LOOK RIGHT LOOK RIGHT LOOK LEFT LEFT LOOK LEFT LEFT LOOK LEFT LEFT LOOK	 turn right look turn right look turn right look turn right look turn right look turn right look turn right look turn left turn left look turn left turn left look turn left turn left look
jump opposite right thrice and walk around right thrice ->	RIGHT RIGHT JUMP RIGHT RIGHT JUMP RIGHT RIGHT JUMP RIGHT WALK RIGHT WALK RIGHT WALK RIGHT WALK RIGHT WALK RIGHT WALK RIGHT WALK RIGHT WALK RIGHT WALK RIGHT WALK RIGHT WALK RIGHT WALK	 turn right turn right jump turn right turn right jump turn right turn right jump turn right walk turn right walk turn right walk turn right walk turn right walk turn right walk turn right walk turn right walk turn right walk
walk around left thrice and walk around left thrice ->	LEFT WALK LEFT WALK LEFT WALK LEFT WALK LEFT WALK LEFT WALK LEFT WALK LEFT WALK LEFT WALK LEFT WALK LEFT WALK LEFT WALK LEFT WALK LEFT WALK LEFT WALK LEFT WALK LEFT WALK LEFT WALK LEFT WALK LEFT WALK LEFT WALK LEFT WALK LEFT WALK LEFT WALK	 turn left walk turn left walk turn left walk turn left walk turn left walk turn left walk turn left walk turn left walk turn left walk turn left walk turn left walk turn left walk turn left walk turn left walk
jump around right thrice and run opposite left thrice ->	RIGHT JUMP RIGHT JUMP RIGHT JUMP RIGHT JUMP RIGHT JUMP RIGHT JUMP RIGHT JUMP RIGHT JUMP RIGHT JUMP RIGHT JUMP RIGHT JUMP RIGHT JUMP LEFT LEFT RUN LEFT LEFT RUN LEFT LEFT RUN	 turn right jump turn right jump turn right jump turn right jump turn right jump turn right jump turn right jump turn right jump turn right jump turn right jump turn left turn left run turn left turn left run turn left turn left run
run around left thrice and walk right twice ->	LEFT RUN LEFT RUN LEFT RUN LEFT RUN LEFT RUN LEFT RUN LEFT RUN LEFT RUN LEFT RUN LEFT RUN LEFT RUN LEFT RUN RIGHT WALK RIGHT WALK	 turn left run turn left run turn left run turn left run turn left run turn left run turn left run turn left run turn left run turn right walk turn right walk
run around right thrice after run around left thrice ->	LEFT RUN LEFT RUN LEFT RUN LEFT RUN LEFT RUN LEFT RUN LEFT RUN LEFT RUN LEFT RUN LEFT RUN LEFT RUN LEFT RUN RIGHT RUN RIGHT RUN RIGHT RUN RIGHT RUN RIGHT RUN RIGHT RUN RIGHT RUN RIGHT RUN RIGHT RUN RIGHT RUN RIGHT RUN RIGHT RUN	 turn left run turn left run turn left run turn left run turn left run turn left run turn left run turn left run turn right run turn right run turn right run turn right run turn right run turn right run turn right run turn right run turn right run turn right run turn right run
look around right thrice and look opposite right thrice ->	RIGHT LOOK RIGHT LOOK RIGHT LOOK RIGHT LOOK RIGHT LOOK RIGHT LOOK RIGHT LOOK RIGHT LOOK RIGHT LOOK RIGHT LOOK RIGHT LOOK RIGHT LOOK RIGHT RIGHT LOOK RIGHT RIGHT LOOK RIGHT RIGHT LOOK	 turn right look turn right look turn right look turn right look turn right look turn right look turn right look turn right look turn right look turn right look turn right look turn right look turn right look turn right look
run right thrice after jump around left thrice ->	LEFT JUMP LEFT JUMP LEFT JUMP LEFT JUMP LEFT JUMP LEFT JUMP LEFT JUMP LEFT JUMP LEFT JUMP LEFT JUMP LEFT JUMP LEFT JUMP RIGHT RUN RIGHT RUN RIGHT RUN	 turn left jump turn left jump turn left jump turn left jump turn left jump turn left jump turn left jump turn left jump turn left jump turn right run turn right run turn right run
run around left after run around right thrice ->	RIGHT RUN RIGHT RUN RIGHT RUN RIGHT RUN RIGHT RUN RIGHT RUN RIGHT RUN RIGHT RUN RIGHT RUN RIGHT RUN RIGHT RUN RIGHT RUN LEFT RUN LEFT RUN LEFT RUN LEFT RUN	 turn right run turn right run turn right run turn right run turn right run turn right run turn right run turn right run turn left run turn left run turn left run turn left run turn left run
look around left thrice and run thrice ->	LEFT LOOK LEFT LOOK LEFT LOOK LEFT LOOK LEFT LOOK LEFT LOOK LEFT LOOK LEFT LOOK LEFT LOOK LEFT LOOK LEFT LOOK LEFT LOOK RUN RUN RUN	 turn left look turn left look turn left look turn left look turn left look turn left look turn left look turn left look turn left look turn left look run run run
look around right thrice and look opposite left thrice ->	RIGHT LOOK RIGHT LOOK RIGHT LOOK RIGHT LOOK RIGHT LOOK RIGHT LOOK RIGHT LOOK RIGHT LOOK RIGHT LOOK RIGHT LOOK RIGHT LOOK RIGHT LOOK LEFT LEFT LOOK LEFT LEFT LOOK LEFT LEFT LOOK	 turn right look turn right look turn right look turn right look turn right look turn right look turn right look turn right look turn left turn left look turn left turn left look turn left turn left look
look opposite left thrice after jump around right twice ->	RIGHT JUMP RIGHT JUMP RIGHT JUMP RIGHT JUMP RIGHT JUMP RIGHT JUMP RIGHT JUMP RIGHT JUMP LEFT LEFT LOOK LEFT LEFT LOOK LEFT LEFT LOOK	 turn right jump turn right jump turn right jump turn right jump turn right jump turn right jump turn right jump turn right jump turn left turn left look turn left turn left look turn left turn left look
walk opposite right twice and walk around right thrice ->	RIGHT RIGHT WALK RIGHT RIGHT WALK RIGHT WALK RIGHT WALK RIGHT WALK RIGHT WALK RIGHT WALK RIGHT WALK RIGHT WALK RIGHT WALK RIGHT WALK RIGHT WALK RIGHT WALK RIGHT WALK	 turn right turn right walk turn right turn right walk turn right walk turn right walk turn right walk turn right walk turn right walk turn right walk turn right walk turn right walk
look opposite left twice and run around right thrice ->	LEFT LEFT LOOK LEFT LEFT LOOK RIGHT RUN RIGHT RUN RIGHT RUN RIGHT RUN RIGHT RUN RIGHT RUN RIGHT RUN RIGHT RUN RIGHT RUN RIGHT RUN RIGHT RUN RIGHT RUN	 turn left turn left look turn left turn left look turn right run turn right run turn right run turn right run turn right run turn right run turn right run turn right run turn right run
turn around left twice after jump around right thrice ->	RIGHT JUMP RIGHT JUMP RIGHT JUMP RIGHT JUMP RIGHT JUMP RIGHT JUMP RIGHT JUMP RIGHT JUMP RIGHT JUMP RIGHT JUMP RIGHT JUMP RIGHT JUMP LEFT LEFT LEFT LEFT LEFT LEFT LEFT LEFT	 turn right jump turn right jump turn right jump turn right jump turn right jump turn right jump turn right jump turn right jump turn left turn left turn left turn left turn left turn left turn left turn left turn left
look around right thrice after jump opposite right thrice ->	RIGHT RIGHT JUMP RIGHT RIGHT JUMP RIGHT RIGHT JUMP RIGHT LOOK RIGHT LOOK RIGHT LOOK RIGHT LOOK RIGHT LOOK RIGHT LOOK RIGHT LOOK RIGHT LOOK RIGHT LOOK RIGHT LOOK RIGHT LOOK RIGHT LOOK	 turn right turn right jump turn right turn right jump turn right turn right jump turn right look turn right look turn right look turn right look turn right look turn right look turn right look turn right look turn right look
run around right after look around left thrice ->	LEFT LOOK LEFT LOOK LEFT LOOK LEFT LOOK LEFT LOOK LEFT LOOK LEFT LOOK LEFT LOOK LEFT LOOK LEFT LOOK LEFT LOOK LEFT LOOK RIGHT RUN RIGHT RUN RIGHT RUN RIGHT RUN	 turn left look turn left look turn left look turn left look turn left look turn left look turn left look turn left look turn right run turn right run turn right run turn right run
jump around right thrice after walk left twice ->	LEFT WALK LEFT WALK RIGHT JUMP RIGHT JUMP RIGHT JUMP RIGHT JUMP RIGHT JUMP RIGHT JUMP RIGHT JUMP RIGHT JUMP RIGHT JUMP RIGHT JUMP RIGHT JUMP RIGHT JUMP	 turn left walk turn left walk turn right jump turn right jump turn right jump turn right jump turn right jump turn right jump turn right jump turn right jump turn right jump
turn opposite right twice after jump around left thrice ->	LEFT JUMP LEFT JUMP LEFT JUMP LEFT JUMP LEFT JUMP LEFT JUMP LEFT JUMP LEFT JUMP LEFT JUMP LEFT JUMP LEFT JUMP LEFT JUMP RIGHT RIGHT RIGHT RIGHT	 turn left jump turn left jump turn left jump turn left jump turn left jump turn left jump turn left jump turn left jump turn right turn right turn right turn right
walk around left thrice and run right thrice ->	LEFT WALK LEFT WALK LEFT WALK LEFT WALK LEFT WALK LEFT WALK LEFT WALK LEFT WALK LEFT WALK LEFT WALK LEFT WALK LEFT WALK RIGHT RUN RIGHT RUN RIGHT RUN	 turn left walk turn left walk turn left walk turn left walk turn left walk turn left walk turn left walk turn left walk turn left walk turn right run turn right run turn right run turn right run
run left twice and jump around left thrice ->	LEFT RUN LEFT RUN LEFT JUMP LEFT JUMP LEFT JUMP LEFT JUMP LEFT JUMP LEFT JUMP LEFT JUMP LEFT JUMP LEFT JUMP LEFT JUMP LEFT JUMP LEFT JUMP	 turn left run turn left run turn left jump turn left jump turn left jump turn left jump turn left jump turn left jump turn left jump turn left jump
walk around left twice and turn around right thrice ->	LEFT WALK LEFT WALK LEFT WALK LEFT WALK LEFT WALK LEFT WALK LEFT WALK LEFT WALK RIGHT RIGHT RIGHT RIGHT RIGHT RIGHT RIGHT RIGHT RIGHT RIGHT RIGHT RIGHT	 turn left walk turn left walk turn left walk turn left walk turn left walk turn left walk turn left walk turn left walk turn left walk turn right turn right turn right turn right turn right turn right turn right turn right turn right turn right turn right
look around right thrice and jump right thrice ->	RIGHT LOOK RIGHT LOOK RIGHT LOOK RIGHT LOOK RIGHT LOOK RIGHT LOOK RIGHT LOOK RIGHT LOOK RIGHT LOOK RIGHT LOOK RIGHT LOOK RIGHT LOOK RIGHT JUMP RIGHT JUMP RIGHT JUMP	 turn right look turn right look turn right look turn right look turn right look turn right look turn right look turn right look turn right look turn right jump turn right jump turn right jump
jump around right after jump around right twice ->	RIGHT JUMP RIGHT JUMP RIGHT JUMP RIGHT JUMP RIGHT JUMP RIGHT JUMP RIGHT JUMP RIGHT JUMP RIGHT JUMP RIGHT JUMP RIGHT JUMP RIGHT JUMP	 turn right jump turn right jump turn right jump turn right jump turn right jump turn right jump turn right jump turn right jump turn right jump turn right jump
look around left after run around right twice ->	RIGHT RUN RIGHT RUN RIGHT RUN RIGHT RUN RIGHT RUN RIGHT RUN RIGHT RUN RIGHT RUN LEFT LOOK LEFT LOOK LEFT LOOK LEFT LOOK	 turn right run turn right run turn right run turn right run turn right run turn right run turn right run turn left look turn left look turn left look turn left look turn left look
turn around left and jump around left thrice ->	LEFT LEFT LEFT LEFT LEFT JUMP LEFT JUMP LEFT JUMP LEFT JUMP LEFT JUMP LEFT JUMP LEFT JUMP LEFT JUMP LEFT JUMP LEFT JUMP LEFT JUMP LEFT JUMP	 turn left turn left turn left turn left turn left jump turn left jump turn left jump turn left jump turn left jump turn left jump turn left jump turn left jump turn left jump
look around right twice after jump around right thrice ->	RIGHT JUMP RIGHT JUMP RIGHT JUMP RIGHT JUMP RIGHT JUMP RIGHT JUMP RIGHT JUMP RIGHT JUMP RIGHT JUMP RIGHT JUMP RIGHT JUMP RIGHT JUMP RIGHT LOOK RIGHT LOOK RIGHT LOOK RIGHT LOOK RIGHT LOOK RIGHT LOOK RIGHT LOOK RIGHT LOOK	 turn right jump turn right jump turn right jump turn right jump turn right jump turn right jump turn right jump turn right jump turn right jump turn right look turn right look turn right look turn right look turn right look turn right look turn right look
run opposite left thrice and jump around left thrice ->	LEFT LEFT RUN LEFT LEFT RUN LEFT LEFT RUN LEFT JUMP LEFT JUMP LEFT JUMP LEFT JUMP LEFT JUMP LEFT JUMP LEFT JUMP LEFT JUMP LEFT JUMP LEFT JUMP LEFT JUMP LEFT JUMP	 turn left turn left run turn left turn left run turn left turn left run turn left jump turn left jump turn left jump turn left jump turn left jump turn left jump turn left jump turn left jump turn left jump
walk around left thrice and jump right twice ->	LEFT WALK LEFT WALK LEFT WALK LEFT WALK LEFT WALK LEFT WALK LEFT WALK LEFT WALK LEFT WALK LEFT WALK LEFT WALK LEFT WALK RIGHT JUMP RIGHT JUMP	 turn left walk turn left walk turn left walk turn left walk turn left walk turn left walk turn left walk turn left walk turn left walk turn right jump turn right jump
turn around right thrice and jump around left twice ->	RIGHT RIGHT RIGHT RIGHT RIGHT RIGHT RIGHT RIGHT RIGHT RIGHT RIGHT RIGHT LEFT JUMP LEFT JUMP LEFT JUMP LEFT JUMP LEFT JUMP LEFT JUMP LEFT JUMP LEFT JUMP	 turn right turn right turn right turn right turn right turn right turn right turn right turn right turn right turn right turn right turn left jump turn left jump turn left jump turn left jump turn left jump
run around right thrice and look opposite left thrice ->	RIGHT RUN RIGHT RUN RIGHT RUN RIGHT RUN RIGHT RUN RIGHT RUN RIGHT RUN RIGHT RUN RIGHT RUN RIGHT RUN RIGHT RUN RIGHT RUN LEFT LEFT LOOK LEFT LEFT LOOK LEFT LEFT LOOK	 turn right run turn right run turn right run turn right run turn right run turn right run turn right run turn right run turn right run turn left turn left look turn left turn left look turn left turn left look turn left turn left look
jump around left thrice after look left thrice ->	LEFT LOOK LEFT LOOK LEFT LOOK LEFT JUMP LEFT JUMP LEFT JUMP LEFT JUMP LEFT JUMP LEFT JUMP LEFT JUMP LEFT JUMP LEFT JUMP LEFT JUMP LEFT JUMP LEFT JUMP	 turn left look turn left look turn left look turn left jump turn left jump turn left jump turn left jump turn left jump turn left jump turn left jump turn left jump turn left jump
jump after run around left thrice ->	LEFT RUN LEFT RUN LEFT RUN LEFT RUN LEFT RUN LEFT RUN LEFT RUN LEFT RUN LEFT RUN LEFT RUN LEFT RUN LEFT RUN JUMP	 turn left run turn left run turn left run turn left run turn left run turn left run turn left run turn left run turn left run turn left run jump
jump around left twice after look around left twice ->	LEFT LOOK LEFT LOOK LEFT LOOK LEFT LOOK LEFT LOOK LEFT LOOK LEFT LOOK LEFT LOOK LEFT JUMP LEFT JUMP LEFT JUMP LEFT JUMP LEFT JUMP LEFT JUMP LEFT JUMP LEFT JUMP	 turn left look turn left look turn left look turn left look turn left look turn left look turn left look turn left look turn left look turn left jump turn left jump turn left jump turn left jump turn left jump turn left jump turn left jump
turn around right thrice and look around left thrice ->	RIGHT RIGHT RIGHT RIGHT RIGHT RIGHT RIGHT RIGHT RIGHT RIGHT RIGHT RIGHT LEFT LOOK LEFT LOOK LEFT LOOK LEFT LOOK LEFT LOOK LEFT LOOK LEFT LOOK LEFT LOOK LEFT LOOK LEFT LOOK LEFT LOOK LEFT LOOK	 turn right turn right turn right turn right turn right turn right turn right turn right turn right turn right turn right turn right turn right turn left look turn left look turn left look turn left look turn left look turn left look turn left look turn left look turn left look turn left look
walk around left thrice after jump right thrice ->	RIGHT JUMP RIGHT JUMP RIGHT JUMP LEFT WALK LEFT WALK LEFT WALK LEFT WALK LEFT WALK LEFT WALK LEFT WALK LEFT WALK LEFT WALK LEFT WALK LEFT WALK LEFT WALK	 turn right jump turn right jump turn right jump turn left walk turn left walk turn left walk turn left walk turn left walk turn left walk turn left walk turn left walk turn left walk turn left walk
jump right twice and walk around left thrice ->	RIGHT JUMP RIGHT JUMP LEFT WALK LEFT WALK LEFT WALK LEFT WALK LEFT WALK LEFT WALK LEFT WALK LEFT WALK LEFT WALK LEFT WALK LEFT WALK LEFT WALK	 turn right jump turn right jump turn left walk turn left walk turn left walk turn left walk turn left walk turn left walk turn left walk turn left walk turn left walk
walk around right and jump around right twice ->	RIGHT WALK RIGHT WALK RIGHT WALK RIGHT WALK RIGHT JUMP RIGHT JUMP RIGHT JUMP RIGHT JUMP RIGHT JUMP RIGHT JUMP RIGHT JUMP RIGHT JUMP	 turn right walk turn right walk turn right walk turn right walk turn right jump turn right jump turn right jump turn right jump turn right jump turn right jump turn right jump turn right jump turn right jump
jump around right thrice after jump around right twice ->	RIGHT JUMP RIGHT JUMP RIGHT JUMP RIGHT JUMP RIGHT JUMP RIGHT JUMP RIGHT JUMP RIGHT JUMP RIGHT JUMP RIGHT JUMP RIGHT JUMP RIGHT JUMP RIGHT JUMP RIGHT JUMP RIGHT JUMP RIGHT JUMP RIGHT JUMP RIGHT JUMP RIGHT JUMP RIGHT JUMP	 turn right jump turn right jump turn right jump turn right jump turn right jump turn right jump turn right jump turn right jump turn right jump turn right jump turn right jump turn right jump turn right jump turn right jump turn right jump
look around right twice and run around right ->	RIGHT LOOK RIGHT LOOK RIGHT LOOK RIGHT LOOK RIGHT LOOK RIGHT LOOK RIGHT LOOK RIGHT LOOK RIGHT RUN RIGHT RUN RIGHT RUN RIGHT RUN	 turn right look turn right look turn right look turn right look turn right look turn right look turn right look turn right look turn right run turn right run turn right run turn right run
jump around right thrice after jump right ->	RIGHT JUMP RIGHT JUMP RIGHT JUMP RIGHT JUMP RIGHT JUMP RIGHT JUMP RIGHT JUMP RIGHT JUMP RIGHT JUMP RIGHT JUMP RIGHT JUMP RIGHT JUMP RIGHT JUMP	 turn right jump turn right jump turn right jump turn right jump turn right jump turn right jump turn right jump turn right jump turn right jump turn right jump
walk left thrice after run around right thrice ->	RIGHT RUN RIGHT RUN RIGHT RUN RIGHT RUN RIGHT RUN RIGHT RUN RIGHT RUN RIGHT RUN RIGHT RUN RIGHT RUN RIGHT RUN RIGHT RUN LEFT WALK LEFT WALK LEFT WALK	 turn right run turn right run turn right run turn right run turn right run turn right run turn right run turn right run turn right run turn left walk turn left walk turn left walk
jump after jump around right thrice ->	RIGHT JUMP RIGHT JUMP RIGHT JUMP RIGHT JUMP RIGHT JUMP RIGHT JUMP RIGHT JUMP RIGHT JUMP RIGHT JUMP RIGHT JUMP RIGHT JUMP RIGHT JUMP JUMP	 turn right jump turn right jump turn right jump turn right jump turn right jump turn right jump turn right jump turn right jump turn right jump turn right jump
walk around left thrice after walk left ->	LEFT WALK LEFT WALK LEFT WALK LEFT WALK LEFT WALK LEFT WALK LEFT WALK LEFT WALK LEFT WALK LEFT WALK LEFT WALK LEFT WALK LEFT WALK	 turn left walk turn left walk turn left walk turn left walk turn left walk turn left walk turn left walk turn left walk turn left walk turn left walk
jump around right thrice after turn around right twice ->	RIGHT RIGHT RIGHT RIGHT RIGHT RIGHT RIGHT RIGHT RIGHT JUMP RIGHT JUMP RIGHT JUMP RIGHT JUMP RIGHT JUMP RIGHT JUMP RIGHT JUMP RIGHT JUMP RIGHT JUMP RIGHT JUMP RIGHT JUMP RIGHT JUMP	 turn right turn right turn right turn right turn right turn right turn right turn right turn right jump turn right jump turn right jump turn right jump turn right jump turn right jump turn right jump turn right jump turn right jump
turn around left thrice and turn around right thrice ->	LEFT LEFT LEFT LEFT LEFT LEFT LEFT LEFT LEFT LEFT LEFT LEFT RIGHT RIGHT RIGHT RIGHT RIGHT RIGHT RIGHT RIGHT RIGHT RIGHT RIGHT RIGHT	 turn left turn left turn left turn left turn left turn left turn left turn left turn left turn left turn left turn left turn left turn left turn right turn right turn right turn right turn right turn right turn right turn right turn right turn right turn right
look and look around left thrice ->	LOOK LEFT LOOK LEFT LOOK LEFT LOOK LEFT LOOK LEFT LOOK LEFT LOOK LEFT LOOK LEFT LOOK LEFT LOOK LEFT LOOK LEFT LOOK LEFT LOOK	 look turn left look turn left look turn left look turn left look turn left look turn left look turn left look turn left look turn left look turn left look
look around left twice after jump around right thrice ->	RIGHT JUMP RIGHT JUMP RIGHT JUMP RIGHT JUMP RIGHT JUMP RIGHT JUMP RIGHT JUMP RIGHT JUMP RIGHT JUMP RIGHT JUMP RIGHT JUMP RIGHT JUMP LEFT LOOK LEFT LOOK LEFT LOOK LEFT LOOK LEFT LOOK LEFT LOOK LEFT LOOK LEFT LOOK	 turn right jump turn right jump turn right jump turn right jump turn right jump turn right jump turn right jump turn right jump turn left look turn left look turn left look turn left look turn left look turn left look turn left look turn left look turn left look
turn around left twice after walk around right twice ->	RIGHT WALK RIGHT WALK RIGHT WALK RIGHT WALK RIGHT WALK RIGHT WALK RIGHT WALK RIGHT WALK LEFT LEFT LEFT LEFT LEFT LEFT LEFT LEFT	 turn right walk turn right walk turn right walk turn right walk turn right walk turn right walk turn right walk turn right walk turn left turn left turn left turn left turn left turn left turn left turn left
look around left thrice and run around left twice ->	LEFT LOOK LEFT LOOK LEFT LOOK LEFT LOOK LEFT LOOK LEFT LOOK LEFT LOOK LEFT LOOK LEFT LOOK LEFT LOOK LEFT LOOK LEFT LOOK LEFT RUN LEFT RUN LEFT RUN LEFT RUN LEFT RUN LEFT RUN LEFT RUN LEFT RUN	 turn left look turn left look turn left look turn left look turn left look turn left look turn left look turn left look turn left look turn left look turn left run turn left run turn left run turn left run turn left run turn left run turn left run
look around left thrice and look around left twice ->	LEFT LOOK LEFT LOOK LEFT LOOK LEFT LOOK LEFT LOOK LEFT LOOK LEFT LOOK LEFT LOOK LEFT LOOK LEFT LOOK LEFT LOOK LEFT LOOK LEFT LOOK LEFT LOOK LEFT LOOK LEFT LOOK LEFT LOOK LEFT LOOK LEFT LOOK LEFT LOOK	 turn left look turn left look turn left look turn left look turn left look turn left look turn left look turn left look turn left look turn left look turn left look turn left look turn left look turn left look
jump around left thrice and jump twice ->	LEFT JUMP LEFT JUMP LEFT JUMP LEFT JUMP LEFT JUMP LEFT JUMP LEFT JUMP LEFT JUMP LEFT JUMP LEFT JUMP LEFT JUMP LEFT JUMP JUMP JUMP	 turn left jump turn left jump turn left jump turn left jump turn left jump turn left jump turn left jump turn left jump turn left jump turn left jump jump jump
jump around left thrice after look left twice ->	LEFT LOOK LEFT LOOK LEFT JUMP LEFT JUMP LEFT JUMP LEFT JUMP LEFT JUMP LEFT JUMP LEFT JUMP LEFT JUMP LEFT JUMP LEFT JUMP LEFT JUMP LEFT JUMP	 turn left look turn left look turn left jump turn left jump turn left jump turn left jump turn left jump turn left jump turn left jump turn left jump turn left jump
jump around right thrice after jump around left ->	LEFT JUMP LEFT JUMP LEFT JUMP LEFT JUMP RIGHT JUMP RIGHT JUMP RIGHT JUMP RIGHT JUMP RIGHT JUMP RIGHT JUMP RIGHT JUMP RIGHT JUMP RIGHT JUMP RIGHT JUMP RIGHT JUMP RIGHT JUMP	 turn left jump turn left jump turn left jump turn right jump turn right jump turn right jump turn right jump turn right jump turn right jump turn right jump turn right jump
look around right twice after jump opposite left thrice ->	LEFT LEFT JUMP LEFT LEFT JUMP LEFT LEFT JUMP RIGHT LOOK RIGHT LOOK RIGHT LOOK RIGHT LOOK RIGHT LOOK RIGHT LOOK RIGHT LOOK RIGHT LOOK	 turn left turn left jump turn left turn left jump turn left turn left jump turn right look turn right look turn right look turn right look turn right look turn right look turn right look turn right look
walk around right twice after run around right ->	RIGHT RUN RIGHT RUN RIGHT RUN RIGHT RUN RIGHT WALK RIGHT WALK RIGHT WALK RIGHT WALK RIGHT WALK RIGHT WALK RIGHT WALK RIGHT WALK	 turn right run turn right run turn right run turn right run turn right walk turn right walk turn right walk turn right walk turn right walk turn right walk turn right walk turn right walk
jump opposite left thrice after jump around left twice ->	LEFT JUMP LEFT JUMP LEFT JUMP LEFT JUMP LEFT JUMP LEFT JUMP LEFT JUMP LEFT JUMP LEFT LEFT JUMP LEFT LEFT JUMP LEFT LEFT JUMP	 turn left jump turn left jump turn left jump turn left jump turn left jump turn left jump turn left jump turn left jump turn left jump turn left jump turn left jump
look around left after run around right thrice ->	RIGHT RUN RIGHT RUN RIGHT RUN RIGHT RUN RIGHT RUN RIGHT RUN RIGHT RUN RIGHT RUN RIGHT RUN RIGHT RUN RIGHT RUN RIGHT RUN LEFT LOOK LEFT LOOK LEFT LOOK LEFT LOOK	 turn right run turn right run turn right run turn right run turn right run turn right run turn right run turn right run turn right run turn left look turn left look turn left look turn left look
jump twice and run around right thrice ->	JUMP JUMP RIGHT RUN RIGHT RUN RIGHT RUN RIGHT RUN RIGHT RUN RIGHT RUN RIGHT RUN RIGHT RUN RIGHT RUN RIGHT RUN RIGHT RUN RIGHT RUN	 jump jump turn right run turn right run turn right run turn right run turn right run turn right run turn right run turn right run turn right run
walk opposite right thrice after look around left twice ->	LEFT LOOK LEFT LOOK LEFT LOOK LEFT LOOK LEFT LOOK LEFT LOOK LEFT LOOK LEFT LOOK RIGHT RIGHT WALK RIGHT RIGHT WALK RIGHT RIGHT WALK	 turn left look turn left look turn left look turn left look turn left look turn left look turn left look turn right turn right walk turn right turn right walk turn right turn right walk
walk around left thrice and turn right ->	LEFT WALK LEFT WALK LEFT WALK LEFT WALK LEFT WALK LEFT WALK LEFT WALK LEFT WALK LEFT WALK LEFT WALK LEFT WALK LEFT WALK RIGHT	 turn left walk turn left walk turn left walk turn left walk turn left walk turn left walk turn left walk turn left walk turn right
run around left thrice after run ->	RUN LEFT RUN LEFT RUN LEFT RUN LEFT RUN LEFT RUN LEFT RUN LEFT RUN LEFT RUN LEFT RUN LEFT RUN LEFT RUN LEFT RUN	 run turn left run turn left run turn left run turn left run turn left run turn left run turn left run turn left run turn left run turn left run
walk around left thrice after run left ->	LEFT RUN LEFT WALK LEFT WALK LEFT WALK LEFT WALK LEFT WALK LEFT WALK LEFT WALK LEFT WALK LEFT WALK LEFT WALK LEFT WALK LEFT WALK	 turn left run turn left walk turn left walk turn left walk turn left walk turn left walk turn left walk turn left walk turn left walk turn left walk
walk around left and run around left twice ->	LEFT WALK LEFT WALK LEFT WALK LEFT WALK LEFT RUN LEFT RUN LEFT RUN LEFT RUN LEFT RUN LEFT RUN LEFT RUN LEFT RUN	 turn left walk turn left walk turn left walk turn left walk turn left walk turn left run turn left run turn left run turn left run turn left run turn left run turn left run
run around right thrice after turn right twice ->	RIGHT RIGHT RIGHT RUN RIGHT RUN RIGHT RUN RIGHT RUN RIGHT RUN RIGHT RUN RIGHT RUN RIGHT RUN RIGHT RUN RIGHT RUN RIGHT RUN RIGHT RUN	 turn right turn right turn right run turn right run turn right run turn right run turn right run turn right run turn right run turn right run turn right run
walk around left thrice and walk opposite right ->	LEFT WALK LEFT WALK LEFT WALK LEFT WALK LEFT WALK LEFT WALK LEFT WALK LEFT WALK LEFT WALK LEFT WALK LEFT WALK LEFT WALK RIGHT RIGHT WALK	 turn left walk turn left walk turn left walk turn left walk turn left walk turn left walk turn left walk turn left walk turn right turn right walk
jump opposite right thrice and jump around right thrice ->	RIGHT RIGHT JUMP RIGHT RIGHT JUMP RIGHT RIGHT JUMP RIGHT JUMP RIGHT JUMP RIGHT JUMP RIGHT JUMP RIGHT JUMP RIGHT JUMP RIGHT JUMP RIGHT JUMP RIGHT JUMP RIGHT JUMP RIGHT JUMP RIGHT JUMP	 turn right turn right jump turn right turn right jump turn right turn right jump turn right jump turn right jump turn right jump turn right jump turn right jump turn right jump turn right jump turn right jump
run opposite left and run around left thrice ->	LEFT LEFT RUN LEFT RUN LEFT RUN LEFT RUN LEFT RUN LEFT RUN LEFT RUN LEFT RUN LEFT RUN LEFT RUN LEFT RUN LEFT RUN LEFT RUN	 turn left turn left run turn left run turn left run turn left run turn left run turn left run turn left run turn left run turn left run turn left run turn left run
look opposite right thrice and walk around left thrice ->	RIGHT RIGHT LOOK RIGHT RIGHT LOOK RIGHT RIGHT LOOK LEFT WALK LEFT WALK LEFT WALK LEFT WALK LEFT WALK LEFT WALK LEFT WALK LEFT WALK LEFT WALK LEFT WALK LEFT WALK LEFT WALK	 turn right turn right look turn right turn right look turn right turn right look turn left walk turn left walk turn left walk turn left walk turn left walk turn left walk turn left walk turn left walk turn left walk
walk around left thrice and jump around left twice ->	LEFT WALK LEFT WALK LEFT WALK LEFT WALK LEFT WALK LEFT WALK LEFT WALK LEFT WALK LEFT WALK LEFT WALK LEFT WALK LEFT WALK LEFT JUMP LEFT JUMP LEFT JUMP LEFT JUMP LEFT JUMP LEFT JUMP LEFT JUMP LEFT JUMP	 turn left walk turn left walk turn left walk turn left walk turn left walk turn left walk turn left walk turn left walk turn left walk turn left jump turn left jump turn left jump turn left jump turn left jump
run around right thrice after look ->	LOOK RIGHT RUN RIGHT RUN RIGHT RUN RIGHT RUN RIGHT RUN RIGHT RUN RIGHT RUN RIGHT RUN RIGHT RUN RIGHT RUN RIGHT RUN RIGHT RUN	 look turn right run turn right run turn right run turn right run turn right run turn right run turn right run turn right run turn right run
walk around right twice after jump around right thrice ->	RIGHT JUMP RIGHT JUMP RIGHT JUMP RIGHT JUMP RIGHT JUMP RIGHT JUMP RIGHT JUMP RIGHT JUMP RIGHT JUMP RIGHT JUMP RIGHT JUMP RIGHT JUMP RIGHT WALK RIGHT WALK RIGHT WALK RIGHT WALK RIGHT WALK RIGHT WALK RIGHT WALK RIGHT WALK	 turn right jump turn right jump turn right jump turn right jump turn right jump turn right jump turn right jump turn right jump turn right walk turn right walk turn right walk turn right walk turn right walk turn right walk turn right walk turn right walk
walk around right twice and walk around right twice ->	RIGHT WALK RIGHT WALK RIGHT WALK RIGHT WALK RIGHT WALK RIGHT WALK RIGHT WALK RIGHT WALK RIGHT WALK RIGHT WALK RIGHT WALK RIGHT WALK RIGHT WALK RIGHT WALK RIGHT WALK RIGHT WALK	 turn right walk turn right walk turn right walk turn right walk turn right walk turn right walk turn right walk turn right walk turn right walk turn right walk turn right walk turn right walk turn right walk turn right walk
turn opposite left thrice after jump around right thrice ->	RIGHT JUMP RIGHT JUMP RIGHT JUMP RIGHT JUMP RIGHT JUMP RIGHT JUMP RIGHT JUMP RIGHT JUMP RIGHT JUMP RIGHT JUMP RIGHT JUMP RIGHT JUMP LEFT LEFT LEFT LEFT LEFT LEFT	 turn right jump turn right jump turn right jump turn right jump turn right jump turn right jump turn right jump turn right jump turn right jump turn left turn left turn left turn left turn left turn left
walk around left thrice after run right thrice ->	RIGHT RUN RIGHT RUN RIGHT RUN LEFT WALK LEFT WALK LEFT WALK LEFT WALK LEFT WALK LEFT WALK LEFT WALK LEFT WALK LEFT WALK LEFT WALK LEFT WALK LEFT WALK	 turn right run turn right run turn right run turn left walk turn left walk turn left walk turn left walk turn left walk turn left walk turn left walk turn left walk turn left walk
look around right twice and walk around right ->	RIGHT LOOK RIGHT LOOK RIGHT LOOK RIGHT LOOK RIGHT LOOK RIGHT LOOK RIGHT LOOK RIGHT LOOK RIGHT WALK RIGHT WALK RIGHT WALK RIGHT WALK	 turn right look turn right look turn right look turn right look turn right look turn right look turn right look turn right look turn right walk turn right walk turn right walk
run left thrice after walk around left thrice ->	LEFT WALK LEFT WALK LEFT WALK LEFT WALK LEFT WALK LEFT WALK LEFT WALK LEFT WALK LEFT WALK LEFT WALK LEFT WALK LEFT WALK LEFT RUN LEFT RUN LEFT RUN	 turn left walk turn left walk turn left walk turn left walk turn left walk turn left walk turn left walk turn left walk turn left walk turn left run turn left run turn left run
walk opposite right twice after walk around left thrice ->	LEFT WALK LEFT WALK LEFT WALK LEFT WALK LEFT WALK LEFT WALK LEFT WALK LEFT WALK LEFT WALK LEFT WALK LEFT WALK LEFT WALK RIGHT RIGHT WALK RIGHT RIGHT WALK	 turn left walk turn left walk turn left walk turn left walk turn left walk turn left walk turn left walk turn left walk turn right turn right walk turn right turn right walk
look and jump around left thrice ->	LOOK LEFT JUMP LEFT JUMP LEFT JUMP LEFT JUMP LEFT JUMP LEFT JUMP LEFT JUMP LEFT JUMP LEFT JUMP LEFT JUMP LEFT JUMP LEFT JUMP	 look turn left jump turn left jump turn left jump turn left jump turn left jump turn left jump turn left jump turn left jump turn left jump
run around right thrice and turn around right ->	RIGHT RUN RIGHT RUN RIGHT RUN RIGHT RUN RIGHT RUN RIGHT RUN RIGHT RUN RIGHT RUN RIGHT RUN RIGHT RUN RIGHT RUN RIGHT RUN RIGHT RIGHT RIGHT RIGHT	 turn right run turn right run turn right run turn right run turn right run turn right run turn right run turn right run turn right run turn right turn right turn right turn right
walk around right after run around right twice ->	RIGHT RUN RIGHT RUN RIGHT RUN RIGHT RUN RIGHT RUN RIGHT RUN RIGHT RUN RIGHT RUN RIGHT WALK RIGHT WALK RIGHT WALK RIGHT WALK	 turn right run turn right run turn right run turn right run turn right run turn right run turn right run turn right run turn right walk turn right walk turn right walk turn right walk
run around right thrice after look opposite right thrice ->	RIGHT RIGHT LOOK RIGHT RIGHT LOOK RIGHT RIGHT LOOK RIGHT RUN RIGHT RUN RIGHT RUN RIGHT RUN RIGHT RUN RIGHT RUN RIGHT RUN RIGHT RUN RIGHT RUN RIGHT RUN RIGHT RUN RIGHT RUN	 turn right turn right look turn right turn right look turn right turn right look turn right run turn right run turn right run turn right run turn right run turn right run turn right run turn right run turn right run turn right run
run around right thrice after run left twice ->	LEFT RUN LEFT RUN RIGHT RUN RIGHT RUN RIGHT RUN RIGHT RUN RIGHT RUN RIGHT RUN RIGHT RUN RIGHT RUN RIGHT RUN RIGHT RUN RIGHT RUN RIGHT RUN	 turn left run turn left run turn right run turn right run turn right run turn right run turn right run turn right run turn right run turn right run turn right run turn right run
walk around right thrice and turn left twice ->	RIGHT WALK RIGHT WALK RIGHT WALK RIGHT WALK RIGHT WALK RIGHT WALK RIGHT WALK RIGHT WALK RIGHT WALK RIGHT WALK RIGHT WALK RIGHT WALK LEFT LEFT	 turn right walk turn right walk turn right walk turn right walk turn right walk turn right walk turn right walk turn right walk turn left turn left
walk around right thrice after jump around right ->	RIGHT JUMP RIGHT JUMP RIGHT JUMP RIGHT JUMP RIGHT WALK RIGHT WALK RIGHT WALK RIGHT WALK RIGHT WALK RIGHT WALK RIGHT WALK RIGHT WALK RIGHT WALK RIGHT WALK RIGHT WALK RIGHT WALK	 turn right jump turn right jump turn right jump turn right walk turn right walk turn right walk turn right walk turn right walk turn right walk turn right walk turn right walk turn right walk
jump left after jump around right thrice ->	RIGHT JUMP RIGHT JUMP RIGHT JUMP RIGHT JUMP RIGHT JUMP RIGHT JUMP RIGHT JUMP RIGHT JUMP RIGHT JUMP RIGHT JUMP RIGHT JUMP RIGHT JUMP LEFT JUMP	 turn right jump turn right jump turn right jump turn right jump turn right jump turn right jump turn right jump turn right jump turn right jump turn right jump
jump around left thrice and walk around right ->	LEFT JUMP LEFT JUMP LEFT JUMP LEFT JUMP LEFT JUMP LEFT JUMP LEFT JUMP LEFT JUMP LEFT JUMP LEFT JUMP LEFT JUMP LEFT JUMP RIGHT WALK RIGHT WALK RIGHT WALK RIGHT WALK	 turn left jump turn left jump turn left jump turn left jump turn left jump turn left jump turn left jump turn left jump turn left jump turn right walk turn right walk turn right walk turn right walk
run around right thrice and run opposite right thrice ->	RIGHT RUN RIGHT RUN RIGHT RUN RIGHT RUN RIGHT RUN RIGHT RUN RIGHT RUN RIGHT RUN RIGHT RUN RIGHT RUN RIGHT RUN RIGHT RUN RIGHT RIGHT RUN RIGHT RIGHT RUN RIGHT RIGHT RUN	 turn right run turn right run turn right run turn right run turn right run turn right run turn right run turn right run turn right turn right run turn right turn right run turn right turn right run
look around right thrice and jump right twice ->	RIGHT LOOK RIGHT LOOK RIGHT LOOK RIGHT LOOK RIGHT LOOK RIGHT LOOK RIGHT LOOK RIGHT LOOK RIGHT LOOK RIGHT LOOK RIGHT LOOK RIGHT LOOK RIGHT JUMP RIGHT JUMP	 turn right look turn right look turn right look turn right look turn right look turn right look turn right look turn right look turn right jump turn right jump
walk around left twice after look opposite left thrice ->	LEFT LEFT LOOK LEFT LEFT LOOK LEFT LEFT LOOK LEFT WALK LEFT WALK LEFT WALK LEFT WALK LEFT WALK LEFT WALK LEFT WALK LEFT WALK	 turn left turn left look turn left turn left look turn left turn left look turn left walk turn left walk turn left walk turn left walk turn left walk turn left walk turn left walk turn left walk
look around right thrice and jump left ->	RIGHT LOOK RIGHT LOOK RIGHT LOOK RIGHT LOOK RIGHT LOOK RIGHT LOOK RIGHT LOOK RIGHT LOOK RIGHT LOOK RIGHT LOOK RIGHT LOOK RIGHT LOOK LEFT JUMP	 turn right look turn right look turn right look turn right look turn right look turn right look turn right look turn right look turn right look turn left jump
jump left thrice after look around right thrice ->	RIGHT LOOK RIGHT LOOK RIGHT LOOK RIGHT LOOK RIGHT LOOK RIGHT LOOK RIGHT LOOK RIGHT LOOK RIGHT LOOK RIGHT LOOK RIGHT LOOK RIGHT LOOK LEFT JUMP LEFT JUMP LEFT JUMP	 turn right look turn right look turn right look turn right look turn right look turn right look turn right look turn right look turn right look turn left jump turn left jump turn left jump
turn right thrice after walk around right thrice ->	RIGHT WALK RIGHT WALK RIGHT WALK RIGHT WALK RIGHT WALK RIGHT WALK RIGHT WALK RIGHT WALK RIGHT WALK RIGHT WALK RIGHT WALK RIGHT WALK RIGHT RIGHT RIGHT	 turn right walk turn right walk turn right walk turn right walk turn right walk turn right walk turn right walk turn right walk turn right walk turn right turn right turn right turn right
walk around right thrice and walk around right thrice ->	RIGHT WALK RIGHT WALK RIGHT WALK RIGHT WALK RIGHT WALK RIGHT WALK RIGHT WALK RIGHT WALK RIGHT WALK RIGHT WALK RIGHT WALK RIGHT WALK RIGHT WALK RIGHT WALK RIGHT WALK RIGHT WALK RIGHT WALK RIGHT WALK RIGHT WALK RIGHT WALK RIGHT WALK RIGHT WALK RIGHT WALK RIGHT WALK	 turn right walk turn right walk turn right walk turn right walk turn right walk turn right walk turn right walk turn right walk turn right walk turn right walk turn right walk turn right walk turn right walk turn right walk
turn opposite right thrice after run around left thrice ->	LEFT RUN LEFT RUN LEFT RUN LEFT RUN LEFT RUN LEFT RUN LEFT RUN LEFT RUN LEFT RUN LEFT RUN LEFT RUN LEFT RUN RIGHT RIGHT RIGHT RIGHT RIGHT RIGHT	 turn left run turn left run turn left run turn left run turn left run turn left run turn left run turn left run turn left run turn left run turn right turn right turn right turn right turn right
look around right thrice and look around right ->	RIGHT LOOK RIGHT LOOK RIGHT LOOK RIGHT LOOK RIGHT LOOK RIGHT LOOK RIGHT LOOK RIGHT LOOK RIGHT LOOK RIGHT LOOK RIGHT LOOK RIGHT LOOK RIGHT LOOK RIGHT LOOK RIGHT LOOK RIGHT LOOK	 turn right look turn right look turn right look turn right look turn right look turn right look turn right look turn right look turn right look turn right look turn right look
run around left twice and walk around right ->	LEFT RUN LEFT RUN LEFT RUN LEFT RUN LEFT RUN LEFT RUN LEFT RUN LEFT RUN RIGHT WALK RIGHT WALK RIGHT WALK RIGHT WALK	 turn left run turn left run turn left run turn left run turn left run turn left run turn left run turn right walk turn right walk turn right walk turn right walk
jump opposite right thrice after look around right twice ->	RIGHT LOOK RIGHT LOOK RIGHT LOOK RIGHT LOOK RIGHT LOOK RIGHT LOOK RIGHT LOOK RIGHT LOOK RIGHT RIGHT JUMP RIGHT RIGHT JUMP RIGHT RIGHT JUMP	 turn right look turn right look turn right look turn right look turn right look turn right look turn right look turn right turn right jump turn right turn right jump turn right turn right jump
walk around left thrice after jump ->	JUMP LEFT WALK LEFT WALK LEFT WALK LEFT WALK LEFT WALK LEFT WALK LEFT WALK LEFT WALK LEFT WALK LEFT WALK LEFT WALK LEFT WALK	 jump turn left walk turn left walk turn left walk turn left walk turn left walk turn left walk turn left walk turn left walk turn left walk
jump around left after run around left twice ->	LEFT RUN LEFT RUN LEFT RUN LEFT RUN LEFT RUN LEFT RUN LEFT RUN LEFT RUN LEFT JUMP LEFT JUMP LEFT JUMP LEFT JUMP	 turn left run turn left run turn left run turn left run turn left run turn left run turn left run turn left run turn left jump turn left jump turn left jump turn left jump
jump around right thrice after walk right thrice ->	RIGHT WALK RIGHT WALK RIGHT WALK RIGHT JUMP RIGHT JUMP RIGHT JUMP RIGHT JUMP RIGHT JUMP RIGHT JUMP RIGHT JUMP RIGHT JUMP RIGHT JUMP RIGHT JUMP RIGHT JUMP RIGHT JUMP	 turn right walk turn right walk turn right walk turn right jump turn right jump turn right jump turn right jump turn right jump turn right jump turn right jump turn right jump turn right jump turn right jump
look around left thrice after jump opposite left twice ->	LEFT LEFT JUMP LEFT LEFT JUMP LEFT LOOK LEFT LOOK LEFT LOOK LEFT LOOK LEFT LOOK LEFT LOOK LEFT LOOK LEFT LOOK LEFT LOOK LEFT LOOK LEFT LOOK LEFT LOOK	 turn left turn left jump turn left turn left jump turn left look turn left look turn left look turn left look turn left look turn left look turn left look turn left look turn left look turn left look
look around left thrice after jump twice ->	JUMP JUMP LEFT LOOK LEFT LOOK LEFT LOOK LEFT LOOK LEFT LOOK LEFT LOOK LEFT LOOK LEFT LOOK LEFT LOOK LEFT LOOK LEFT LOOK LEFT LOOK	 jump jump turn left look turn left look turn left look turn left look turn left look turn left look turn left look turn left look turn left look turn left look
look around left thrice and look opposite right ->	LEFT LOOK LEFT LOOK LEFT LOOK LEFT LOOK LEFT LOOK LEFT LOOK LEFT LOOK LEFT LOOK LEFT LOOK LEFT LOOK LEFT LOOK LEFT LOOK RIGHT RIGHT LOOK	 turn left look turn left look turn left look turn left look turn left look turn left look turn left look turn left look turn right turn right look
turn around left twice after look around left twice ->	LEFT LOOK LEFT LOOK LEFT LOOK LEFT LOOK LEFT LOOK LEFT LOOK LEFT LOOK LEFT LOOK LEFT LEFT LEFT LEFT LEFT LEFT LEFT LEFT	 turn left look turn left look turn left look turn left look turn left look turn left look turn left look turn left look turn left look turn left turn left turn left turn left turn left turn left turn left
walk around right twice after look around right twice ->	RIGHT LOOK RIGHT LOOK RIGHT LOOK RIGHT LOOK RIGHT LOOK RIGHT LOOK RIGHT LOOK RIGHT LOOK RIGHT WALK RIGHT WALK RIGHT WALK RIGHT WALK RIGHT WALK RIGHT WALK RIGHT WALK RIGHT WALK	 turn right look turn right look turn right look turn right look turn right look turn right look turn right look turn right look turn right walk turn right walk turn right walk turn right walk turn right walk turn right walk turn right walk
walk opposite right and walk around right thrice ->	RIGHT RIGHT WALK RIGHT WALK RIGHT WALK RIGHT WALK RIGHT WALK RIGHT WALK RIGHT WALK RIGHT WALK RIGHT WALK RIGHT WALK RIGHT WALK RIGHT WALK RIGHT WALK	 turn right turn right walk turn right walk turn right walk turn right walk turn right walk turn right walk turn right walk turn right walk turn right walk turn right walk
jump around left twice and look opposite left thrice ->	LEFT JUMP LEFT JUMP LEFT JUMP LEFT JUMP LEFT JUMP LEFT JUMP LEFT JUMP LEFT JUMP LEFT LEFT LOOK LEFT LEFT LOOK LEFT LEFT LOOK	 turn left jump turn left jump turn left jump turn left jump turn left jump turn left jump turn left jump turn left turn left look turn left turn left look turn left turn left look
run thrice and jump around right thrice ->	RUN RUN RUN RIGHT JUMP RIGHT JUMP RIGHT JUMP RIGHT JUMP RIGHT JUMP RIGHT JUMP RIGHT JUMP RIGHT JUMP RIGHT JUMP RIGHT JUMP RIGHT JUMP RIGHT JUMP	 run run run turn right jump turn right jump turn right jump turn right jump turn right jump turn right jump turn right jump turn right jump turn right jump
jump opposite right twice after jump around right thrice ->	RIGHT JUMP RIGHT JUMP RIGHT JUMP RIGHT JUMP RIGHT JUMP RIGHT JUMP RIGHT JUMP RIGHT JUMP RIGHT JUMP RIGHT JUMP RIGHT JUMP RIGHT JUMP RIGHT RIGHT JUMP RIGHT RIGHT JUMP	 turn right jump turn right jump turn right jump turn right jump turn right jump turn right jump turn right jump turn right jump turn right jump turn right jump turn right jump
walk around right thrice and look thrice ->	RIGHT WALK RIGHT WALK RIGHT WALK RIGHT WALK RIGHT WALK RIGHT WALK RIGHT WALK RIGHT WALK RIGHT WALK RIGHT WALK RIGHT WALK RIGHT WALK LOOK LOOK LOOK	 turn right walk turn right walk turn right walk turn right walk turn right walk turn right walk turn right walk turn right walk turn right walk look look look
look around left thrice after walk twice ->	WALK WALK LEFT LOOK LEFT LOOK LEFT LOOK LEFT LOOK LEFT LOOK LEFT LOOK LEFT LOOK LEFT LOOK LEFT LOOK LEFT LOOK LEFT LOOK LEFT LOOK	 walk walk turn left look turn left look turn left look turn left look turn left look turn left look turn left look turn left look turn left look turn left look
walk around right twice after jump around left thrice ->	LEFT JUMP LEFT JUMP LEFT JUMP LEFT JUMP LEFT JUMP LEFT JUMP LEFT JUMP LEFT JUMP LEFT JUMP LEFT JUMP LEFT JUMP LEFT JUMP RIGHT WALK RIGHT WALK RIGHT WALK RIGHT WALK RIGHT WALK RIGHT WALK RIGHT WALK RIGHT WALK	 turn left jump turn left jump turn left jump turn left jump turn left jump turn left jump turn left jump turn right walk turn right walk turn right walk turn right walk turn right walk turn right walk turn right walk turn right walk turn right walk
jump around right thrice and walk opposite left ->	RIGHT JUMP RIGHT JUMP RIGHT JUMP RIGHT JUMP RIGHT JUMP RIGHT JUMP RIGHT JUMP RIGHT JUMP RIGHT JUMP RIGHT JUMP RIGHT JUMP RIGHT JUMP LEFT LEFT WALK	 turn right jump turn right jump turn right jump turn right jump turn right jump turn right jump turn right jump turn right jump turn right jump turn left turn left walk
jump around right thrice after turn opposite right twice ->	RIGHT RIGHT RIGHT RIGHT RIGHT JUMP RIGHT JUMP RIGHT JUMP RIGHT JUMP RIGHT JUMP RIGHT JUMP RIGHT JUMP RIGHT JUMP RIGHT JUMP RIGHT JUMP RIGHT JUMP RIGHT JUMP	 turn right turn right turn right turn right turn right jump turn right jump turn right jump turn right jump turn right jump turn right jump turn right jump turn right jump turn right jump
look around left twice and look around left thrice ->	LEFT LOOK LEFT LOOK LEFT LOOK LEFT LOOK LEFT LOOK LEFT LOOK LEFT LOOK LEFT LOOK LEFT LOOK LEFT LOOK LEFT LOOK LEFT LOOK LEFT LOOK LEFT LOOK LEFT LOOK LEFT LOOK LEFT LOOK LEFT LOOK LEFT LOOK LEFT LOOK	 turn left look turn left look turn left look turn left look turn left look turn left look turn left look turn left look turn left look turn left look turn left look turn left look turn left look turn left look turn left look
look opposite right twice after run around left thrice ->	LEFT RUN LEFT RUN LEFT RUN LEFT RUN LEFT RUN LEFT RUN LEFT RUN LEFT RUN LEFT RUN LEFT RUN LEFT RUN LEFT RUN RIGHT RIGHT LOOK RIGHT RIGHT LOOK	 turn left run turn left run turn left run turn left run turn left run turn left run turn left run turn left run turn left run turn right turn right look turn right turn right look
run around right thrice and run opposite left twice ->	RIGHT RUN RIGHT RUN RIGHT RUN RIGHT RUN RIGHT RUN RIGHT RUN RIGHT RUN RIGHT RUN RIGHT RUN RIGHT RUN RIGHT RUN RIGHT RUN LEFT LEFT RUN LEFT LEFT RUN	 turn right run turn right run turn right run turn right run turn right run turn right run turn right run turn right run turn left turn left run turn left turn left run
look around right after walk around right twice ->	RIGHT WALK RIGHT WALK RIGHT WALK RIGHT WALK RIGHT WALK RIGHT WALK RIGHT WALK RIGHT WALK RIGHT LOOK RIGHT LOOK RIGHT LOOK RIGHT LOOK	 turn right walk turn right walk turn right walk turn right walk turn right walk turn right walk turn right walk turn right look turn right look turn right look turn right look
walk around right thrice and look opposite right twice ->	RIGHT WALK RIGHT WALK RIGHT WALK RIGHT WALK RIGHT WALK RIGHT WALK RIGHT WALK RIGHT WALK RIGHT WALK RIGHT WALK RIGHT WALK RIGHT WALK RIGHT RIGHT LOOK RIGHT RIGHT LOOK	 turn right walk turn right walk turn right walk turn right walk turn right walk turn right walk turn right walk turn right walk turn right turn right look turn right turn right look
run right thrice and walk around right thrice ->	RIGHT RUN RIGHT RUN RIGHT RUN RIGHT WALK RIGHT WALK RIGHT WALK RIGHT WALK RIGHT WALK RIGHT WALK RIGHT WALK RIGHT WALK RIGHT WALK RIGHT WALK RIGHT WALK RIGHT WALK	 turn right run turn right run turn right run turn right walk turn right walk turn right walk turn right walk turn right walk turn right walk turn right walk turn right walk turn right walk
run opposite left thrice after jump around left twice ->	LEFT JUMP LEFT JUMP LEFT JUMP LEFT JUMP LEFT JUMP LEFT JUMP LEFT JUMP LEFT JUMP LEFT LEFT RUN LEFT LEFT RUN LEFT LEFT RUN	 turn left jump turn left jump turn left jump turn left jump turn left jump turn left jump turn left jump turn left jump turn left turn left run turn left turn left run turn left turn left run
turn around right twice and look around right twice ->	I_TURN_RIGHT I_TURN_RIGHT I_TURN_RIGHT I_TURN_RIGHT I_TURN_RIGHT I_TURN_RIGHT I_TURN_RIGHT I_TURN_RIGHT I_TURN_RIGHT I_LOOK I_TURN_RIGHT I_LOOK I_TURN_RIGHT I_LOOK I_TURN_RIGHT I_LOOK I_TURN_RIGHT I_LOOK I_TURN_RIGHT I_LOOK I_TURN_RIGHT I_LOOK I_TURN_RIGHT I_LOOK	 turn right turn right turn right turn right turn right turn right turn right turn right turn right look turn right look turn right look turn right look turn right look turn right look turn right look turn right look
jump around right thrice and run opposite left twice ->	I_TURN_RIGHT I_JUMP I_TURN_RIGHT I_JUMP I_TURN_RIGHT I_JUMP I_TURN_RIGHT I_JUMP I_TURN_RIGHT I_JUMP I_TURN_RIGHT I_JUMP I_TURN_RIGHT I_JUMP I_TURN_RIGHT I_JUMP I_TURN_RIGHT I_JUMP I_TURN_RIGHT I_JUMP I_TURN_RIGHT I_JUMP I_TURN_RIGHT I_JUMP I_TURN_LEFT I_TURN_LEFT I_RUN I_TURN_LEFT I_TURN_LEFT I_RUN	 turn right jump turn right jump turn right jump turn right jump turn right jump turn right jump turn right jump turn right jump turn right jump turn left turn left run turn left turn left run
run around right and look around right twice ->	I_TURN_RIGHT I_RUN I_TURN_RIGHT I_RUN I_TURN_RIGHT I_RUN I_TURN_RIGHT I_RUN I_TURN_RIGHT I_LOOK I_TURN_RIGHT I_LOOK I_TURN_RIGHT I_LOOK I_TURN_RIGHT I_LOOK I_TURN_RIGHT I_LOOK I_TURN_RIGHT I_LOOK I_TURN_RIGHT I_LOOK I_TURN_RIGHT I_LOOK	 turn right run turn right run turn right run turn right run turn right look turn right look turn right look turn right look turn right look turn right look turn right look turn right look
run around left thrice after turn left ->	I_TURN_LEFT I_TURN_LEFT I_RUN I_TURN_LEFT I_RUN I_TURN_LEFT I_RUN I_TURN_LEFT I_RUN I_TURN_LEFT I_RUN I_TURN_LEFT I_RUN I_TURN_LEFT I_RUN I_TURN_LEFT I_RUN I_TURN_LEFT I_RUN I_TURN_LEFT I_RUN I_TURN_LEFT I_RUN I_TURN_LEFT I_RUN	 turn left turn left run turn left run turn left run turn left run turn left run turn left run turn left run turn left run turn left run
look around left thrice after turn opposite right twice ->	I_TURN_RIGHT I_TURN_RIGHT I_TURN_RIGHT I_TURN_RIGHT I_TURN_LEFT I_LOOK I_TURN_LEFT I_LOOK I_TURN_LEFT I_LOOK I_TURN_LEFT I_LOOK I_TURN_LEFT I_LOOK I_TURN_LEFT I_LOOK I_TURN_LEFT I_LOOK I_TURN_LEFT I_LOOK I_TURN_LEFT I_LOOK I_TURN_LEFT I_LOOK I_TURN_LEFT I_LOOK I_TURN_LEFT I_LOOK	 turn right turn right turn right turn right turn left look turn left look turn left look turn left look turn left look turn left look turn left look turn left look turn left look turn left look
jump opposite right twice and look around right thrice ->	I_TURN_RIGHT I_TURN_RIGHT I_JUMP I_TURN_RIGHT I_TURN_RIGHT I_JUMP I_TURN_RIGHT I_LOOK I_TURN_RIGHT I_LOOK I_TURN_RIGHT I_LOOK I_TURN_RIGHT I_LOOK I_TURN_RIGHT I_LOOK I_TURN_RIGHT I_LOOK I_TURN_RIGHT I_LOOK I_TURN_RIGHT I_LOOK I_TURN_RIGHT I_LOOK I_TURN_RIGHT I_LOOK I_TURN_RIGHT I_LOOK I_TURN_RIGHT I_LOOK	 turn right turn right jump turn right turn right jump turn right look turn right look turn right look turn right look turn right look turn right look turn right look turn right look turn right look
jump around right twice and run opposite left thrice ->	I_TURN_RIGHT I_JUMP I_TURN_RIGHT I_JUMP I_TURN_RIGHT I_JUMP I_TURN_RIGHT I_JUMP I_TURN_RIGHT I_JUMP I_TURN_RIGHT I_JUMP I_TURN_RIGHT I_JUMP I_TURN_RIGHT I_JUMP I_TURN_LEFT I_TURN_LEFT I_RUN I_TURN_LEFT I_TURN_LEFT I_RUN I_TURN_LEFT I_TURN_LEFT I_RUN	 turn right jump turn right jump turn right jump turn right jump turn right jump turn right jump turn right jump turn right jump turn left turn left run turn left turn left run turn left turn left run
walk and run around right thrice ->	I_WALK I_TURN_RIGHT I_RUN I_TURN_RIGHT I_RUN I_TURN_RIGHT I_RUN I_TURN_RIGHT I_RUN I_TURN_RIGHT I_RUN I_TURN_RIGHT I_RUN I_TURN_RIGHT I_RUN I_TURN_RIGHT I_RUN I_TURN_RIGHT I_RUN I_TURN_RIGHT I_RUN I_TURN_RIGHT I_RUN I_TURN_RIGHT I_RUN	 walk turn right run turn right run turn right run turn right run turn right run turn right run turn right run turn right run turn right run
run opposite left thrice after walk around right twice ->	I_TURN_RIGHT I_WALK I_TURN_RIGHT I_WALK I_TURN_RIGHT I_WALK I_TURN_RIGHT I_WALK I_TURN_RIGHT I_WALK I_TURN_RIGHT I_WALK I_TURN_RIGHT I_WALK I_TURN_RIGHT I_WALK I_TURN_LEFT I_TURN_LEFT I_RUN I_TURN_LEFT I_TURN_LEFT I_RUN I_TURN_LEFT I_TURN_LEFT I_RUN	 turn right walk turn right walk turn right walk turn right walk turn right walk turn right walk turn right walk turn left turn left run turn left turn left run turn left turn left run
jump around right thrice and run around left twice ->	I_TURN_RIGHT I_JUMP I_TURN_RIGHT I_JUMP I_TURN_RIGHT I_JUMP I_TURN_RIGHT I_JUMP I_TURN_RIGHT I_JUMP I_TURN_RIGHT I_JUMP I_TURN_RIGHT I_JUMP I_TURN_RIGHT I_JUMP I_TURN_RIGHT I_JUMP I_TURN_RIGHT I_JUMP I_TURN_RIGHT I_JUMP I_TURN_RIGHT I_JUMP I_TURN_LEFT I_RUN I_TURN_LEFT I_RUN I_TURN_LEFT I_RUN I_TURN_LEFT I_RUN I_TURN_LEFT I_RUN I_TURN_LEFT I_RUN I_TURN_LEFT I_RUN I_TURN_LEFT I_RUN	 turn right jump turn right jump turn right jump turn right jump turn right jump turn right jump turn right jump turn right jump turn right jump turn left run turn left run turn left run turn left run turn left run
turn around left twice and jump around right twice ->	I_TURN_LEFT I_TURN_LEFT I_TURN_LEFT I_TURN_LEFT I_TURN_LEFT I_TURN_LEFT I_TURN_LEFT I_TURN_LEFT I_TURN_RIGHT I_JUMP I_TURN_RIGHT I_JUMP I_TURN_RIGHT I_JUMP I_TURN_RIGHT I_JUMP I_TURN_RIGHT I_JUMP I_TURN_RIGHT I_JUMP I_TURN_RIGHT I_JUMP I_TURN_RIGHT I_JUMP	 turn left turn left turn left turn left turn left turn left turn left turn left turn right jump turn right jump turn right jump turn right jump turn right jump turn right jump turn right jump turn right jump
run around right thrice after run right ->	I_TURN_RIGHT I_RUN I_TURN_RIGHT I_RUN I_TURN_RIGHT I_RUN I_TURN_RIGHT I_RUN I_TURN_RIGHT I_RUN I_TURN_RIGHT I_RUN I_TURN_RIGHT I_RUN I_TURN_RIGHT I_RUN I_TURN_RIGHT I_RUN I_TURN_RIGHT I_RUN I_TURN_RIGHT I_RUN I_TURN_RIGHT I_RUN I_TURN_RIGHT I_RUN	 turn right run turn right run turn right run turn right run turn right run turn right run turn right run turn right run turn right run turn right run turn right run
jump around left thrice and walk left ->	I_TURN_LEFT I_JUMP I_TURN_LEFT I_JUMP I_TURN_LEFT I_JUMP I_TURN_LEFT I_JUMP I_TURN_LEFT I_JUMP I_TURN_LEFT I_JUMP I_TURN_LEFT I_JUMP I_TURN_LEFT I_JUMP I_TURN_LEFT I_JUMP I_TURN_LEFT I_JUMP I_TURN_LEFT I_JUMP I_TURN_LEFT I_JUMP I_TURN_LEFT I_WALK	 turn left jump turn left jump turn left jump turn left jump turn left jump turn left jump turn left jump turn left jump turn left jump turn left walk
walk right thrice and run around left thrice ->	I_TURN_RIGHT I_WALK I_TURN_RIGHT I_WALK I_TURN_RIGHT I_WALK I_TURN_LEFT I_RUN I_TURN_LEFT I_RUN I_TURN_LEFT I_RUN I_TURN_LEFT I_RUN I_TURN_LEFT I_RUN I_TURN_LEFT I_RUN I_TURN_LEFT I_RUN I_TURN_LEFT I_RUN I_TURN_LEFT I_RUN I_TURN_LEFT I_RUN I_TURN_LEFT I_RUN I_TURN_LEFT I_RUN	 turn right walk turn right walk turn right walk turn left run turn left run turn left run turn left run turn left run turn left run turn left run turn left run turn left run
jump around left thrice and jump thrice ->	I_TURN_LEFT I_JUMP I_TURN_LEFT I_JUMP I_TURN_LEFT I_JUMP I_TURN_LEFT I_JUMP I_TURN_LEFT I_JUMP I_TURN_LEFT I_JUMP I_TURN_LEFT I_JUMP I_TURN_LEFT I_JUMP I_TURN_LEFT I_JUMP I_TURN_LEFT I_JUMP I_TURN_LEFT I_JUMP I_TURN_LEFT I_JUMP I_JUMP I_JUMP I_JUMP	 turn left jump turn left jump turn left jump turn left jump turn left jump turn left jump turn left jump turn left jump turn left jump jump jump jump
turn around left thrice after jump around left twice ->	I_TURN_LEFT I_JUMP I_TURN_LEFT I_JUMP I_TURN_LEFT I_JUMP I_TURN_LEFT I_JUMP I_TURN_LEFT I_JUMP I_TURN_LEFT I_JUMP I_TURN_LEFT I_JUMP I_TURN_LEFT I_JUMP I_TURN_LEFT I_TURN_LEFT I_TURN_LEFT I_TURN_LEFT I_TURN_LEFT I_TURN_LEFT I_TURN_LEFT I_TURN_LEFT I_TURN_LEFT I_TURN_LEFT I_TURN_LEFT I_TURN_LEFT	 turn left jump turn left jump turn left jump turn left jump turn left jump turn left jump turn left jump turn left jump turn left jump turn left turn left turn left turn left turn left turn left turn left turn left turn left turn left turn left turn left
run around left twice and run around left twice ->	I_TURN_LEFT I_RUN I_TURN_LEFT I_RUN I_TURN_LEFT I_RUN I_TURN_LEFT I_RUN I_TURN_LEFT I_RUN I_TURN_LEFT I_RUN I_TURN_LEFT I_RUN I_TURN_LEFT I_RUN I_TURN_LEFT I_RUN I_TURN_LEFT I_RUN I_TURN_LEFT I_RUN I_TURN_LEFT I_RUN I_TURN_LEFT I_RUN I_TURN_LEFT I_RUN I_TURN_LEFT I_RUN I_TURN_LEFT I_RUN	 turn left run turn left run turn left run turn left run turn left run turn left run turn left run turn left run turn left run turn left run turn left run turn left run turn left run turn left run turn left run
walk around left thrice and look left twice ->	I_TURN_LEFT I_WALK I_TURN_LEFT I_WALK I_TURN_LEFT I_WALK I_TURN_LEFT I_WALK I_TURN_LEFT I_WALK I_TURN_LEFT I_WALK I_TURN_LEFT I_WALK I_TURN_LEFT I_WALK I_TURN_LEFT I_WALK I_TURN_LEFT I_WALK I_TURN_LEFT I_WALK I_TURN_LEFT I_WALK I_TURN_LEFT I_LOOK I_TURN_LEFT I_LOOK	 turn left walk turn left walk turn left walk turn left walk turn left walk turn left walk turn left walk turn left walk turn left walk turn left look turn left look
run around left and walk around right thrice ->	I_TURN_LEFT I_RUN I_TURN_LEFT I_RUN I_TURN_LEFT I_RUN I_TURN_LEFT I_RUN I_TURN_RIGHT I_WALK I_TURN_RIGHT I_WALK I_TURN_RIGHT I_WALK I_TURN_RIGHT I_WALK I_TURN_RIGHT I_WALK I_TURN_RIGHT I_WALK I_TURN_RIGHT I_WALK I_TURN_RIGHT I_WALK I_TURN_RIGHT I_WALK I_TURN_RIGHT I_WALK I_TURN_RIGHT I_WALK I_TURN_RIGHT I_WALK	 turn left run turn left run turn left run turn left run turn right walk turn right walk turn right walk turn right walk turn right walk turn right walk turn right walk turn right walk
look around left thrice after jump left thrice ->	I_TURN_LEFT I_JUMP I_TURN_LEFT I_JUMP I_TURN_LEFT I_JUMP I_TURN_LEFT I_LOOK I_TURN_LEFT I_LOOK I_TURN_LEFT I_LOOK I_TURN_LEFT I_LOOK I_TURN_LEFT I_LOOK I_TURN_LEFT I_LOOK I_TURN_LEFT I_LOOK I_TURN_LEFT I_LOOK I_TURN_LEFT I_LOOK I_TURN_LEFT I_LOOK I_TURN_LEFT I_LOOK I_TURN_LEFT I_LOOK	 turn left jump turn left jump turn left jump turn left look turn left look turn left look turn left look turn left look turn left look turn left look turn left look turn left look turn left look
look around left after look around left thrice ->	I_TURN_LEFT I_LOOK I_TURN_LEFT I_LOOK I_TURN_LEFT I_LOOK I_TURN_LEFT I_LOOK I_TURN_LEFT I_LOOK I_TURN_LEFT I_LOOK I_TURN_LEFT I_LOOK I_TURN_LEFT I_LOOK I_TURN_LEFT I_LOOK I_TURN_LEFT I_LOOK I_TURN_LEFT I_LOOK I_TURN_LEFT I_LOOK I_TURN_LEFT I_LOOK I_TURN_LEFT I_LOOK I_TURN_LEFT I_LOOK I_TURN_LEFT I_LOOK	 turn left look turn left look turn left look turn left look turn left look turn left look turn left look turn left look turn left look turn left look turn left look
walk around left thrice and run around right thrice ->	I_TURN_LEFT I_WALK I_TURN_LEFT I_WALK I_TURN_LEFT I_WALK I_TURN_LEFT I_WALK I_TURN_LEFT I_WALK I_TURN_LEFT I_WALK I_TURN_LEFT I_WALK I_TURN_LEFT I_WALK I_TURN_LEFT I_WALK I_TURN_LEFT I_WALK I_TURN_LEFT I_WALK I_TURN_LEFT I_WALK I_TURN_RIGHT I_RUN I_TURN_RIGHT I_RUN I_TURN_RIGHT I_RUN I_TURN_RIGHT I_RUN I_TURN_RIGHT I_RUN I_TURN_RIGHT I_RUN I_TURN_RIGHT I_RUN I_TURN_RIGHT I_RUN I_TURN_RIGHT I_RUN I_TURN_RIGHT I_RUN I_TURN_RIGHT I_RUN I_TURN_RIGHT I_RUN	 turn left walk turn left walk turn left walk turn left walk turn left walk turn left walk turn left walk turn left walk turn left walk turn right run turn right run turn right run turn right run turn right run turn right run turn right run turn right run turn right run turn right run
run around right twice after walk around right twice ->	I_TURN_RIGHT I_WALK I_TURN_RIGHT I_WALK I_TURN_RIGHT I_WALK I_TURN_RIGHT I_WALK I_TURN_RIGHT I_WALK I_TURN_RIGHT I_WALK I_TURN_RIGHT I_WALK I_TURN_RIGHT I_WALK I_TURN_RIGHT I_RUN I_TURN_RIGHT I_RUN I_TURN_RIGHT I_RUN I_TURN_RIGHT I_RUN I_TURN_RIGHT I_RUN I_TURN_RIGHT I_RUN I_TURN_RIGHT I_RUN I_TURN_RIGHT I_RUN	 turn right walk turn right walk turn right walk turn right walk turn right walk turn right walk turn right walk turn right walk turn right run turn right run turn right run turn right run turn right run turn right run turn right run turn right run
walk opposite right thrice and jump around left twice ->	I_TURN_RIGHT I_TURN_RIGHT I_WALK I_TURN_RIGHT I_TURN_RIGHT I_WALK I_TURN_RIGHT I_TURN_RIGHT I_WALK I_TURN_LEFT I_JUMP I_TURN_LEFT I_JUMP I_TURN_LEFT I_JUMP I_TURN_LEFT I_JUMP I_TURN_LEFT I_JUMP I_TURN_LEFT I_JUMP I_TURN_LEFT I_JUMP I_TURN_LEFT I_JUMP	 turn right turn right walk turn right turn right walk turn right turn right walk turn left jump turn left jump turn left jump turn left jump turn left jump turn left jump turn left jump turn left jump
look around right thrice after jump around right thrice ->	I_TURN_RIGHT I_JUMP I_TURN_RIGHT I_JUMP I_TURN_RIGHT I_JUMP I_TURN_RIGHT I_JUMP I_TURN_RIGHT I_JUMP I_TURN_RIGHT I_JUMP I_TURN_RIGHT I_JUMP I_TURN_RIGHT I_JUMP I_TURN_RIGHT I_JUMP I_TURN_RIGHT I_JUMP I_TURN_RIGHT I_JUMP I_TURN_RIGHT I_JUMP I_TURN_RIGHT I_LOOK I_TURN_RIGHT I_LOOK I_TURN_RIGHT I_LOOK I_TURN_RIGHT I_LOOK I_TURN_RIGHT I_LOOK I_TURN_RIGHT I_LOOK I_TURN_RIGHT I_LOOK I_TURN_RIGHT I_LOOK I_TURN_RIGHT I_LOOK I_TURN_RIGHT I_LOOK I_TURN_RIGHT I_LOOK I_TURN_RIGHT I_LOOK	 turn right jump turn right jump turn right jump turn right jump turn right jump turn right jump turn right jump turn right jump turn right jump turn right look turn right look turn right look turn right look turn right look turn right look turn right look turn right look
look right twice and jump around right thrice ->	I_TURN_RIGHT I_LOOK I_TURN_RIGHT I_LOOK I_TURN_RIGHT I_JUMP I_TURN_RIGHT I_JUMP I_TURN_RIGHT I_JUMP I_TURN_RIGHT I_JUMP I_TURN_RIGHT I_JUMP I_TURN_RIGHT I_JUMP I_TURN_RIGHT I_JUMP I_TURN_RIGHT I_JUMP I_TURN_RIGHT I_JUMP I_TURN_RIGHT I_JUMP I_TURN_RIGHT I_JUMP I_TURN_RIGHT I_JUMP	 turn right look turn right look turn right jump turn right jump turn right jump turn right jump turn right jump turn right jump turn right jump turn right jump
run around right twice after turn around left thrice ->	I_TURN_LEFT I_TURN_LEFT I_TURN_LEFT I_TURN_LEFT I_TURN_LEFT I_TURN_LEFT I_TURN_LEFT I_TURN_LEFT I_TURN_LEFT I_TURN_LEFT I_TURN_LEFT I_TURN_LEFT I_TURN_RIGHT I_RUN I_TURN_RIGHT I_RUN I_TURN_RIGHT I_RUN I_TURN_RIGHT I_RUN I_TURN_RIGHT I_RUN I_TURN_RIGHT I_RUN I_TURN_RIGHT I_RUN I_TURN_RIGHT I_RUN	 turn left turn left turn left turn left turn left turn left turn left turn left turn left turn left turn left turn left turn right run turn right run turn right run turn right run turn right run turn right run turn right run turn right run turn right run turn right run
run around left thrice and turn opposite left twice ->	I_TURN_LEFT I_RUN I_TURN_LEFT I_RUN I_TURN_LEFT I_RUN I_TURN_LEFT I_RUN I_TURN_LEFT I_RUN I_TURN_LEFT I_RUN I_TURN_LEFT I_RUN I_TURN_LEFT I_RUN I_TURN_LEFT I_RUN I_TURN_LEFT I_RUN I_TURN_LEFT I_RUN I_TURN_LEFT I_RUN I_TURN_LEFT I_TURN_LEFT I_TURN_LEFT I_TURN_LEFT	 turn left run turn left run turn left run turn left run turn left run turn left run turn left run turn left run turn left turn left turn left turn left
run around right after walk around left thrice ->	I_TURN_LEFT I_WALK I_TURN_LEFT I_WALK I_TURN_LEFT I_WALK I_TURN_LEFT I_WALK I_TURN_LEFT I_WALK I_TURN_LEFT I_WALK I_TURN_LEFT I_WALK I_TURN_LEFT I_WALK I_TURN_LEFT I_WALK I_TURN_LEFT I_WALK I_TURN_LEFT I_WALK I_TURN_LEFT I_WALK I_TURN_RIGHT I_RUN I_TURN_RIGHT I_RUN I_TURN_RIGHT I_RUN I_TURN_RIGHT I_RUN	 turn left walk turn left walk turn left walk turn left walk turn left walk turn left walk turn left walk turn right run turn right run turn right run turn right run turn right run
jump around right thrice after turn opposite left twice ->	I_TURN_LEFT I_TURN_LEFT I_TURN_LEFT I_TURN_LEFT I_TURN_RIGHT I_JUMP I_TURN_RIGHT I_JUMP I_TURN_RIGHT I_JUMP I_TURN_RIGHT I_JUMP I_TURN_RIGHT I_JUMP I_TURN_RIGHT I_JUMP I_TURN_RIGHT I_JUMP I_TURN_RIGHT I_JUMP I_TURN_RIGHT I_JUMP I_TURN_RIGHT I_JUMP I_TURN_RIGHT I_JUMP I_TURN_RIGHT I_JUMP	 turn left turn left turn left turn left turn right jump turn right jump turn right jump turn right jump turn right jump turn right jump turn right jump turn right jump turn right jump
look around right thrice after walk opposite left ->	I_TURN_LEFT I_TURN_LEFT I_WALK I_TURN_RIGHT I_LOOK I_TURN_RIGHT I_LOOK I_TURN_RIGHT I_LOOK I_TURN_RIGHT I_LOOK I_TURN_RIGHT I_LOOK I_TURN_RIGHT I_LOOK I_TURN_RIGHT I_LOOK I_TURN_RIGHT I_LOOK I_TURN_RIGHT I_LOOK I_TURN_RIGHT I_LOOK I_TURN_RIGHT I_LOOK I_TURN_RIGHT I_LOOK	 turn left turn left walk turn right look turn right look turn right look turn right look turn right look turn right look turn right look turn right look turn right look turn right look
jump around right thrice and turn around right thrice ->	I_TURN_RIGHT I_JUMP I_TURN_RIGHT I_JUMP I_TURN_RIGHT I_JUMP I_TURN_RIGHT I_JUMP I_TURN_RIGHT I_JUMP I_TURN_RIGHT I_JUMP I_TURN_RIGHT I_JUMP I_TURN_RIGHT I_JUMP I_TURN_RIGHT I_JUMP I_TURN_RIGHT I_JUMP I_TURN_RIGHT I_JUMP I_TURN_RIGHT I_JUMP I_TURN_RIGHT I_TURN_RIGHT I_TURN_RIGHT I_TURN_RIGHT I_TURN_RIGHT I_TURN_RIGHT I_TURN_RIGHT I_TURN_RIGHT I_TURN_RIGHT I_TURN_RIGHT I_TURN_RIGHT I_TURN_RIGHT	 turn right jump turn right jump turn right jump turn right jump turn right jump turn right jump turn right jump turn right jump turn right jump turn right jump turn right jump turn right jump turn right turn right turn right turn right turn right turn right turn right turn right
walk thrice after look around left thrice ->	I_TURN_LEFT I_LOOK I_TURN_LEFT I_LOOK I_TURN_LEFT I_LOOK I_TURN_LEFT I_LOOK I_TURN_LEFT I_LOOK I_TURN_LEFT I_LOOK I_TURN_LEFT I_LOOK I_TURN_LEFT I_LOOK I_TURN_LEFT I_LOOK I_TURN_LEFT I_LOOK I_TURN_LEFT I_LOOK I_TURN_LEFT I_LOOK I_WALK I_WALK I_WALK	 turn left look turn left look turn left look turn left look turn left look turn left look turn left look turn left look turn left look walk walk walk
run opposite left thrice after look around left thrice ->	I_TURN_LEFT I_LOOK I_TURN_LEFT I_LOOK I_TURN_LEFT I_LOOK I_TURN_LEFT I_LOOK I_TURN_LEFT I_LOOK I_TURN_LEFT I_LOOK I_TURN_LEFT I_LOOK I_TURN_LEFT I_LOOK I_TURN_LEFT I_LOOK I_TURN_LEFT I_LOOK I_TURN_LEFT I_LOOK I_TURN_LEFT I_LOOK I_TURN_LEFT I_TURN_LEFT I_RUN I_TURN_LEFT I_TURN_LEFT I_RUN I_TURN_LEFT I_TURN_LEFT I_RUN	 turn left look turn left look turn left look turn left look turn left look turn left look turn left look turn left look turn left look turn left turn left run turn left turn left run turn left turn left run
jump opposite left and jump around right thrice ->	I_TURN_LEFT I_TURN_LEFT I_JUMP I_TURN_RIGHT I_JUMP I_TURN_RIGHT I_JUMP I_TURN_RIGHT I_JUMP I_TURN_RIGHT I_JUMP I_TURN_RIGHT I_JUMP I_TURN_RIGHT I_JUMP I_TURN_RIGHT I_JUMP I_TURN_RIGHT I_JUMP I_TURN_RIGHT I_JUMP I_TURN_RIGHT I_JUMP I_TURN_RIGHT I_JUMP I_TURN_RIGHT I_JUMP	 turn left turn left jump turn right jump turn right jump turn right jump turn right jump turn right jump turn right jump turn right jump turn right jump turn right jump
walk around right and look around right thrice ->	I_TURN_RIGHT I_WALK I_TURN_RIGHT I_WALK I_TURN_RIGHT I_WALK I_TURN_RIGHT I_WALK I_TURN_RIGHT I_LOOK I_TURN_RIGHT I_LOOK I_TURN_RIGHT I_LOOK I_TURN_RIGHT I_LOOK I_TURN_RIGHT I_LOOK I_TURN_RIGHT I_LOOK I_TURN_RIGHT I_LOOK I_TURN_RIGHT I_LOOK I_TURN_RIGHT I_LOOK I_TURN_RIGHT I_LOOK I_TURN_RIGHT I_LOOK I_TURN_RIGHT I_LOOK	 turn right walk turn right walk turn right walk turn right walk turn right look turn right look turn right look turn right look turn right look turn right look turn right look turn right look turn right look
walk around right thrice and jump left twice ->	I_TURN_RIGHT I_WALK I_TURN_RIGHT I_WALK I_TURN_RIGHT I_WALK I_TURN_RIGHT I_WALK I_TURN_RIGHT I_WALK I_TURN_RIGHT I_WALK I_TURN_RIGHT I_WALK I_TURN_RIGHT I_WALK I_TURN_RIGHT I_WALK I_TURN_RIGHT I_WALK I_TURN_RIGHT I_WALK I_TURN_RIGHT I_WALK I_TURN_LEFT I_JUMP I_TURN_LEFT I_JUMP	 turn right walk turn right walk turn right walk turn right walk turn right walk turn right walk turn right walk turn right walk turn right walk turn left jump turn left jump
walk around right and run around left thrice ->	I_TURN_RIGHT I_WALK I_TURN_RIGHT I_WALK I_TURN_RIGHT I_WALK I_TURN_RIGHT I_WALK I_TURN_LEFT I_RUN I_TURN_LEFT I_RUN I_TURN_LEFT I_RUN I_TURN_LEFT I_RUN I_TURN_LEFT I_RUN I_TURN_LEFT I_RUN I_TURN_LEFT I_RUN I_TURN_LEFT I_RUN I_TURN_LEFT I_RUN I_TURN_LEFT I_RUN I_TURN_LEFT I_RUN I_TURN_LEFT I_RUN	 turn right walk turn right walk turn right walk turn right walk turn left run turn left run turn left run turn left run turn left run turn left run turn left run turn left run turn left run
jump opposite right thrice and walk around left thrice ->	I_TURN_RIGHT I_TURN_RIGHT I_JUMP I_TURN_RIGHT I_TURN_RIGHT I_JUMP I_TURN_RIGHT I_TURN_RIGHT I_JUMP I_TURN_LEFT I_WALK I_TURN_LEFT I_WALK I_TURN_LEFT I_WALK I_TURN_LEFT I_WALK I_TURN_LEFT I_WALK I_TURN_LEFT I_WALK I_TURN_LEFT I_WALK I_TURN_LEFT I_WALK I_TURN_LEFT I_WALK I_TURN_LEFT I_WALK I_TURN_LEFT I_WALK I_TURN_LEFT I_WALK	 turn right turn right jump turn right turn right jump turn right turn right jump turn left walk turn left walk turn left walk turn left walk turn left walk turn left walk turn left walk turn left walk turn left walk
walk around right thrice after look opposite right ->	I_TURN_RIGHT I_TURN_RIGHT I_LOOK I_TURN_RIGHT I_WALK I_TURN_RIGHT I_WALK I_TURN_RIGHT I_WALK I_TURN_RIGHT I_WALK I_TURN_RIGHT I_WALK I_TURN_RIGHT I_WALK I_TURN_RIGHT I_WALK I_TURN_RIGHT I_WALK I_TURN_RIGHT I_WALK I_TURN_RIGHT I_WALK I_TURN_RIGHT I_WALK I_TURN_RIGHT I_WALK	 turn right turn right look turn right walk turn right walk turn right walk turn right walk turn right walk turn right walk turn right walk turn right walk turn right walk
jump opposite left twice after run around right thrice ->	I_TURN_RIGHT I_RUN I_TURN_RIGHT I_RUN I_TURN_RIGHT I_RUN I_TURN_RIGHT I_RUN I_TURN_RIGHT I_RUN I_TURN_RIGHT I_RUN I_TURN_RIGHT I_RUN I_TURN_RIGHT I_RUN I_TURN_RIGHT I_RUN I_TURN_RIGHT I_RUN I_TURN_RIGHT I_RUN I_TURN_RIGHT I_RUN I_TURN_LEFT I_TURN_LEFT I_JUMP I_TURN_LEFT I_TURN_LEFT I_JUMP	 turn right run turn right run turn right run turn right run turn right run turn right run turn right run turn right run turn left turn left jump turn left turn left jump
jump around right after run around right twice ->	I_TURN_RIGHT I_RUN I_TURN_RIGHT I_RUN I_TURN_RIGHT I_RUN I_TURN_RIGHT I_RUN I_TURN_RIGHT I_RUN I_TURN_RIGHT I_RUN I_TURN_RIGHT I_RUN I_TURN_RIGHT I_RUN I_TURN_RIGHT I_JUMP I_TURN_RIGHT I_JUMP I_TURN_RIGHT I_JUMP I_TURN_RIGHT I_JUMP	 turn right run turn right run turn right run turn right run turn right run turn right run turn right run turn right run turn right jump turn right jump turn right jump turn right jump
turn around left thrice after walk around right thrice ->	I_TURN_RIGHT I_WALK I_TURN_RIGHT I_WALK I_TURN_RIGHT I_WALK I_TURN_RIGHT I_WALK I_TURN_RIGHT I_WALK I_TURN_RIGHT I_WALK I_TURN_RIGHT I_WALK I_TURN_RIGHT I_WALK I_TURN_RIGHT I_WALK I_TURN_RIGHT I_WALK I_TURN_RIGHT I_WALK I_TURN_RIGHT I_WALK I_TURN_LEFT I_TURN_LEFT I_TURN_LEFT I_TURN_LEFT I_TURN_LEFT I_TURN_LEFT I_TURN_LEFT I_TURN_LEFT I_TURN_LEFT I_TURN_LEFT I_TURN_LEFT I_TURN_LEFT	 turn right walk turn right walk turn right walk turn right walk turn right walk turn right walk turn right walk turn right walk turn right walk turn left turn left turn left turn left turn left turn left turn left turn left turn left turn left turn left turn left
run around right twice and turn around left thrice ->	I_TURN_RIGHT I_RUN I_TURN_RIGHT I_RUN I_TURN_RIGHT I_RUN I_TURN_RIGHT I_RUN I_TURN_RIGHT I_RUN I_TURN_RIGHT I_RUN I_TURN_RIGHT I_RUN I_TURN_RIGHT I_RUN I_TURN_LEFT I_TURN_LEFT I_TURN_LEFT I_TURN_LEFT I_TURN_LEFT I_TURN_LEFT I_TURN_LEFT I_TURN_LEFT I_TURN_LEFT I_TURN_LEFT I_TURN_LEFT I_TURN_LEFT	 turn right run turn right run turn right run turn right run turn right run turn right run turn right run turn right run turn right run turn right run turn left turn left turn left turn left turn left turn left turn left turn left turn left
look around right thrice after walk opposite left thrice ->	I_TURN_LEFT I_TURN_LEFT I_WALK I_TURN_LEFT I_TURN_LEFT I_WALK I_TURN_LEFT I_TURN_LEFT I_WALK I_TURN_RIGHT I_LOOK I_TURN_RIGHT I_LOOK I_TURN_RIGHT I_LOOK I_TURN_RIGHT I_LOOK I_TURN_RIGHT I_LOOK I_TURN_RIGHT I_LOOK I_TURN_RIGHT I_LOOK I_TURN_RIGHT I_LOOK I_TURN_RIGHT I_LOOK I_TURN_RIGHT I_LOOK I_TURN_RIGHT I_LOOK I_TURN_RIGHT I_LOOK	 turn left turn left walk turn left turn left walk turn left turn left walk turn right look turn right look turn right look turn right look turn right look turn right look turn right look turn right look turn right look
look around right thrice after look around left twice ->	I_TURN_LEFT I_LOOK I_TURN_LEFT I_LOOK I_TURN_LEFT I_LOOK I_TURN_LEFT I_LOOK I_TURN_LEFT I_LOOK I_TURN_LEFT I_LOOK I_TURN_LEFT I_LOOK I_TURN_LEFT I_LOOK I_TURN_RIGHT I_LOOK I_TURN_RIGHT I_LOOK I_TURN_RIGHT I_LOOK I_TURN_RIGHT I_LOOK I_TURN_RIGHT I_LOOK I_TURN_RIGHT I_LOOK I_TURN_RIGHT I_LOOK I_TURN_RIGHT I_LOOK I_TURN_RIGHT I_LOOK I_TURN_RIGHT I_LOOK I_TURN_RIGHT I_LOOK I_TURN_RIGHT I_LOOK	 turn left look turn left look turn left look turn left look turn left look turn left look turn left look turn right look turn right look turn right look turn right look turn right look turn right look turn right look turn right look turn right look
turn around right thrice and turn around right thrice ->	I_TURN_RIGHT I_TURN_RIGHT I_TURN_RIGHT I_TURN_RIGHT I_TURN_RIGHT I_TURN_RIGHT I_TURN_RIGHT I_TURN_RIGHT I_TURN_RIGHT I_TURN_RIGHT I_TURN_RIGHT I_TURN_RIGHT I_TURN_RIGHT I_TURN_RIGHT I_TURN_RIGHT I_TURN_RIGHT I_TURN_RIGHT I_TURN_RIGHT I_TURN_RIGHT I_TURN_RIGHT I_TURN_RIGHT I_TURN_RIGHT I_TURN_RIGHT I_TURN_RIGHT	 turn right turn right turn right turn right turn right turn right turn right turn right turn right turn right turn right turn right turn right turn right turn right turn right turn right turn right turn right turn right turn right turn right
look around right twice after look around left ->	I_TURN_LEFT I_LOOK I_TURN_LEFT I_LOOK I_TURN_LEFT I_LOOK I_TURN_LEFT I_LOOK I_TURN_RIGHT I_LOOK I_TURN_RIGHT I_LOOK I_TURN_RIGHT I_LOOK I_TURN_RIGHT I_LOOK I_TURN_RIGHT I_LOOK I_TURN_RIGHT I_LOOK I_TURN_RIGHT I_LOOK I_TURN_RIGHT I_LOOK	 turn left look turn left look turn left look turn left look turn right look turn right look turn right look turn right look turn right look turn right look
run opposite left twice after run around left thrice ->	I_TURN_LEFT I_RUN I_TURN_LEFT I_RUN I_TURN_LEFT I_RUN I_TURN_LEFT I_RUN I_TURN_LEFT I_RUN I_TURN_LEFT I_RUN I_TURN_LEFT I_RUN I_TURN_LEFT I_RUN I_TURN_LEFT I_RUN I_TURN_LEFT I_RUN I_TURN_LEFT I_RUN I_TURN_LEFT I_RUN I_TURN_LEFT I_TURN_LEFT I_RUN I_TURN_LEFT I_TURN_LEFT I_RUN	 turn left run turn left run turn left run turn left run turn left run turn left run turn left run turn left run turn left run turn left turn left run turn left turn left run
jump around right thrice and walk opposite right thrice ->	I_TURN_RIGHT I_JUMP I_TURN_RIGHT I_JUMP I_TURN_RIGHT I_JUMP I_TURN_RIGHT I_JUMP I_TURN_RIGHT I_JUMP I_TURN_RIGHT I_JUMP I_TURN_RIGHT I_JUMP I_TURN_RIGHT I_JUMP I_TURN_RIGHT I_JUMP I_TURN_RIGHT I_JUMP I_TURN_RIGHT I_JUMP I_TURN_RIGHT I_JUMP I_TURN_RIGHT I_TURN_RIGHT I_WALK I_TURN_RIGHT I_TURN_RIGHT I_WALK I_TURN_RIGHT I_TURN_RIGHT I_WALK	 turn right jump turn right jump turn right jump turn right jump turn right jump turn right jump turn right jump turn right jump turn right jump turn right jump turn right turn right walk turn right turn right walk turn right turn right walk
look around right thrice after jump thrice ->	I_JUMP I_JUMP I_JUMP I_TURN_RIGHT I_LOOK I_TURN_RIGHT I_LOOK I_TURN_RIGHT I_LOOK I_TURN_RIGHT I_LOOK I_TURN_RIGHT I_LOOK I_TURN_RIGHT I_LOOK I_TURN_RIGHT I_LOOK I_TURN_RIGHT I_LOOK I_TURN_RIGHT I_LOOK I_TURN_RIGHT I_LOOK I_TURN_RIGHT I_LOOK I_TURN_RIGHT I_LOOK	 jump jump jump turn right look turn right look turn right look turn right look turn right look turn right look turn right look turn right look turn right look
look around right and jump around left twice ->	I_TURN_RIGHT I_LOOK I_TURN_RIGHT I_LOOK I_TURN_RIGHT I_LOOK I_TURN_RIGHT I_LOOK I_TURN_LEFT I_JUMP I_TURN_LEFT I_JUMP I_TURN_LEFT I_JUMP I_TURN_LEFT I_JUMP I_TURN_LEFT I_JUMP I_TURN_LEFT I_JUMP I_TURN_LEFT I_JUMP I_TURN_LEFT I_JUMP	 turn right look turn right look turn right look turn right look turn left jump turn left jump turn left jump turn left jump turn left jump turn left jump turn left jump turn left jump
jump opposite right thrice after look around left twice ->	I_TURN_LEFT I_LOOK I_TURN_LEFT I_LOOK I_TURN_LEFT I_LOOK I_TURN_LEFT I_LOOK I_TURN_LEFT I_LOOK I_TURN_LEFT I_LOOK I_TURN_LEFT I_LOOK I_TURN_LEFT I_LOOK I_TURN_RIGHT I_TURN_RIGHT I_JUMP I_TURN_RIGHT I_TURN_RIGHT I_JUMP I_TURN_RIGHT I_TURN_RIGHT I_JUMP	 turn left look turn left look turn left look turn left look turn left look turn left look turn left look turn right turn right jump turn right turn right jump turn right turn right jump
jump around right thrice after look twice ->	I_LOOK I_LOOK I_TURN_RIGHT I_JUMP I_TURN_RIGHT I_JUMP I_TURN_RIGHT I_JUMP I_TURN_RIGHT I_JUMP I_TURN_RIGHT I_JUMP I_TURN_RIGHT I_JUMP I_TURN_RIGHT I_JUMP I_TURN_RIGHT I_JUMP I_TURN_RIGHT I_JUMP I_TURN_RIGHT I_JUMP I_TURN_RIGHT I_JUMP I_TURN_RIGHT I_JUMP	 look look turn right jump turn right jump turn right jump turn right jump turn right jump turn right jump turn right jump turn right jump turn right jump turn right jump
jump around left thrice and run right twice ->	I_TURN_LEFT I_JUMP I_TURN_LEFT I_JUMP I_TURN_LEFT I_JUMP I_TURN_LEFT I_JUMP I_TURN_LEFT I_JUMP I_TURN_LEFT I_JUMP I_TURN_LEFT I_JUMP I_TURN_LEFT I_JUMP I_TURN_LEFT I_JUMP I_TURN_LEFT I_JUMP I_TURN_LEFT I_JUMP I_TURN_LEFT I_JUMP I_TURN_RIGHT I_RUN I_TURN_RIGHT I_RUN	 turn left jump turn left jump turn left jump turn left jump turn left jump turn left jump turn left jump turn left jump turn left jump turn left jump turn right run turn right run
walk and walk around right thrice ->	I_WALK I_TURN_RIGHT I_WALK I_TURN_RIGHT I_WALK I_TURN_RIGHT I_WALK I_TURN_RIGHT I_WALK I_TURN_RIGHT I_WALK I_TURN_RIGHT I_WALK I_TURN_RIGHT I_WALK I_TURN_RIGHT I_WALK I_TURN_RIGHT I_WALK I_TURN_RIGHT I_WALK I_TURN_RIGHT I_WALK I_TURN_RIGHT I_WALK	 walk turn right walk turn right walk turn right walk turn right walk turn right walk turn right walk turn right walk turn right walk turn right walk
walk around left thrice and jump left thrice ->	I_TURN_LEFT I_WALK I_TURN_LEFT I_WALK I_TURN_LEFT I_WALK I_TURN_LEFT I_WALK I_TURN_LEFT I_WALK I_TURN_LEFT I_WALK I_TURN_LEFT I_WALK I_TURN_LEFT I_WALK I_TURN_LEFT I_WALK I_TURN_LEFT I_WALK I_TURN_LEFT I_WALK I_TURN_LEFT I_WALK I_TURN_LEFT I_JUMP I_TURN_LEFT I_JUMP I_TURN_LEFT I_JUMP	 turn left walk turn left walk turn left walk turn left walk turn left walk turn left walk turn left walk turn left walk turn left walk turn left jump turn left jump turn left jump
walk right after walk around left thrice ->	I_TURN_LEFT I_WALK I_TURN_LEFT I_WALK I_TURN_LEFT I_WALK I_TURN_LEFT I_WALK I_TURN_LEFT I_WALK I_TURN_LEFT I_WALK I_TURN_LEFT I_WALK I_TURN_LEFT I_WALK I_TURN_LEFT I_WALK I_TURN_LEFT I_WALK I_TURN_LEFT I_WALK I_TURN_LEFT I_WALK I_TURN_RIGHT I_WALK	 turn left walk turn left walk turn left walk turn left walk turn left walk turn left walk turn left walk turn left walk turn left walk turn left walk turn right walk
walk around right thrice and jump around right twice ->	I_TURN_RIGHT I_WALK I_TURN_RIGHT I_WALK I_TURN_RIGHT I_WALK I_TURN_RIGHT I_WALK I_TURN_RIGHT I_WALK I_TURN_RIGHT I_WALK I_TURN_RIGHT I_WALK I_TURN_RIGHT I_WALK I_TURN_RIGHT I_WALK I_TURN_RIGHT I_WALK I_TURN_RIGHT I_WALK I_TURN_RIGHT I_WALK I_TURN_RIGHT I_JUMP I_TURN_RIGHT I_JUMP I_TURN_RIGHT I_JUMP I_TURN_RIGHT I_JUMP I_TURN_RIGHT I_JUMP I_TURN_RIGHT I_JUMP I_TURN_RIGHT I_JUMP I_TURN_RIGHT I_JUMP	 turn right walk turn right walk turn right walk turn right walk turn right walk turn right walk turn right walk turn right walk turn right walk turn right walk turn right jump turn right jump turn right jump turn right jump
turn around right and look around right thrice ->	I_TURN_RIGHT I_TURN_RIGHT I_TURN_RIGHT I_TURN_RIGHT I_TURN_RIGHT I_LOOK I_TURN_RIGHT I_LOOK I_TURN_RIGHT I_LOOK I_TURN_RIGHT I_LOOK I_TURN_RIGHT I_LOOK I_TURN_RIGHT I_LOOK I_TURN_RIGHT I_LOOK I_TURN_RIGHT I_LOOK I_TURN_RIGHT I_LOOK I_TURN_RIGHT I_LOOK I_TURN_RIGHT I_LOOK I_TURN_RIGHT I_LOOK	 turn right turn right turn right turn right turn right look turn right look turn right look turn right look turn right look turn right look turn right look turn right look turn right look
walk around left thrice and jump around left thrice ->	I_TURN_LEFT I_WALK I_TURN_LEFT I_WALK I_TURN_LEFT I_WALK I_TURN_LEFT I_WALK I_TURN_LEFT I_WALK I_TURN_LEFT I_WALK I_TURN_LEFT I_WALK I_TURN_LEFT I_WALK I_TURN_LEFT I_WALK I_TURN_LEFT I_WALK I_TURN_LEFT I_WALK I_TURN_LEFT I_WALK I_TURN_LEFT I_JUMP I_TURN_LEFT I_JUMP I_TURN_LEFT I_JUMP I_TURN_LEFT I_JUMP I_TURN_LEFT I_JUMP I_TURN_LEFT I_JUMP I_TURN_LEFT I_JUMP I_TURN_LEFT I_JUMP I_TURN_LEFT I_JUMP I_TURN_LEFT I_JUMP I_TURN_LEFT I_JUMP I_TURN_LEFT I_JUMP	 turn left walk turn left walk turn left walk turn left walk turn left walk turn left walk turn left walk turn left walk turn left walk turn left walk turn left jump turn left jump turn left jump turn left jump turn left jump turn left jump turn left jump
look around right thrice after jump left thrice ->	I_TURN_LEFT I_JUMP I_TURN_LEFT I_JUMP I_TURN_LEFT I_JUMP I_TURN_RIGHT I_LOOK I_TURN_RIGHT I_LOOK I_TURN_RIGHT I_LOOK I_TURN_RIGHT I_LOOK I_TURN_RIGHT I_LOOK I_TURN_RIGHT I_LOOK I_TURN_RIGHT I_LOOK I_TURN_RIGHT I_LOOK I_TURN_RIGHT I_LOOK I_TURN_RIGHT I_LOOK I_TURN_RIGHT I_LOOK I_TURN_RIGHT I_LOOK	 turn left jump turn left jump turn left jump turn right look turn right look turn right look turn right look turn right look turn right look turn right look turn right look turn right look turn right look
look around right thrice and turn left twice ->	I_TURN_RIGHT I_LOOK I_TURN_RIGHT I_LOOK I_TURN_RIGHT I_LOOK I_TURN_RIGHT I_LOOK I_TURN_RIGHT I_LOOK I_TURN_RIGHT I_LOOK I_TURN_RIGHT I_LOOK I_TURN_RIGHT I_LOOK I_TURN_RIGHT I_LOOK I_TURN_RIGHT I_LOOK I_TURN_RIGHT I_LOOK I_TURN_RIGHT I_LOOK I_TURN_LEFT I_TURN_LEFT	 turn right look turn right look turn right look turn right look turn right look turn right look turn right look turn right look turn left turn left
walk around right thrice after look around right ->	I_TURN_RIGHT I_LOOK I_TURN_RIGHT I_LOOK I_TURN_RIGHT I_LOOK I_TURN_RIGHT I_LOOK I_TURN_RIGHT I_WALK I_TURN_RIGHT I_WALK I_TURN_RIGHT I_WALK I_TURN_RIGHT I_WALK I_TURN_RIGHT I_WALK I_TURN_RIGHT I_WALK I_TURN_RIGHT I_WALK I_TURN_RIGHT I_WALK I_TURN_RIGHT I_WALK I_TURN_RIGHT I_WALK I_TURN_RIGHT I_WALK I_TURN_RIGHT I_WALK	 turn right look turn right look turn right look turn right look turn right walk turn right walk turn right walk turn right walk turn right walk turn right walk turn right walk turn right walk turn right walk
jump around left twice after walk around left twice ->	I_TURN_LEFT I_WALK I_TURN_LEFT I_WALK I_TURN_LEFT I_WALK I_TURN_LEFT I_WALK I_TURN_LEFT I_WALK I_TURN_LEFT I_WALK I_TURN_LEFT I_WALK I_TURN_LEFT I_WALK I_TURN_LEFT I_JUMP I_TURN_LEFT I_JUMP I_TURN_LEFT I_JUMP I_TURN_LEFT I_JUMP I_TURN_LEFT I_JUMP I_TURN_LEFT I_JUMP I_TURN_LEFT I_JUMP I_TURN_LEFT I_JUMP	 turn left walk turn left walk turn left walk turn left walk turn left walk turn left walk turn left walk turn left jump turn left jump turn left jump turn left jump turn left jump turn left jump turn left jump turn left jump turn left jump
walk around right after run around left twice ->	I_TURN_LEFT I_RUN I_TURN_LEFT I_RUN I_TURN_LEFT I_RUN I_TURN_LEFT I_RUN I_TURN_LEFT I_RUN I_TURN_LEFT I_RUN I_TURN_LEFT I_RUN I_TURN_LEFT I_RUN I_TURN_RIGHT I_WALK I_TURN_RIGHT I_WALK I_TURN_RIGHT I_WALK I_TURN_RIGHT I_WALK	 turn left run turn left run turn left run turn left run turn left run turn left run turn left run turn right walk turn right walk turn right walk turn right walk
run around left thrice after run right ->	I_TURN_RIGHT I_RUN I_TURN_LEFT I_RUN I_TURN_LEFT I_RUN I_TURN_LEFT I_RUN I_TURN_LEFT I_RUN I_TURN_LEFT I_RUN I_TURN_LEFT I_RUN I_TURN_LEFT I_RUN I_TURN_LEFT I_RUN I_TURN_LEFT I_RUN I_TURN_LEFT I_RUN I_TURN_LEFT I_RUN I_TURN_LEFT I_RUN	 turn right run turn left run turn left run turn left run turn left run turn left run turn left run turn left run turn left run turn left run turn left run turn left run
walk around left thrice and turn around right ->	I_TURN_LEFT I_WALK I_TURN_LEFT I_WALK I_TURN_LEFT I_WALK I_TURN_LEFT I_WALK I_TURN_LEFT I_WALK I_TURN_LEFT I_WALK I_TURN_LEFT I_WALK I_TURN_LEFT I_WALK I_TURN_LEFT I_WALK I_TURN_LEFT I_WALK I_TURN_LEFT I_WALK I_TURN_LEFT I_WALK I_TURN_RIGHT I_TURN_RIGHT I_TURN_RIGHT I_TURN_RIGHT	 turn left walk turn left walk turn left walk turn left walk turn left walk turn left walk turn left walk turn left walk turn left walk turn right turn right turn right turn right
jump around left thrice after walk left ->	I_TURN_LEFT I_WALK I_TURN_LEFT I_JUMP I_TURN_LEFT I_JUMP I_TURN_LEFT I_JUMP I_TURN_LEFT I_JUMP I_TURN_LEFT I_JUMP I_TURN_LEFT I_JUMP I_TURN_LEFT I_JUMP I_TURN_LEFT I_JUMP I_TURN_LEFT I_JUMP I_TURN_LEFT I_JUMP I_TURN_LEFT I_JUMP I_TURN_LEFT I_JUMP	 turn left walk turn left jump turn left jump turn left jump turn left jump turn left jump turn left jump turn left jump turn left jump turn left jump
look around left twice after jump opposite left thrice ->	I_TURN_LEFT I_TURN_LEFT I_JUMP I_TURN_LEFT I_TURN_LEFT I_JUMP I_TURN_LEFT I_TURN_LEFT I_JUMP I_TURN_LEFT I_LOOK I_TURN_LEFT I_LOOK I_TURN_LEFT I_LOOK I_TURN_LEFT I_LOOK I_TURN_LEFT I_LOOK I_TURN_LEFT I_LOOK I_TURN_LEFT I_LOOK I_TURN_LEFT I_LOOK	 turn left turn left jump turn left turn left jump turn left turn left jump turn left look turn left look turn left look turn left look turn left look turn left look turn left look turn left look
walk around right twice after run around left thrice ->	I_TURN_LEFT I_RUN I_TURN_LEFT I_RUN I_TURN_LEFT I_RUN I_TURN_LEFT I_RUN I_TURN_LEFT I_RUN I_TURN_LEFT I_RUN I_TURN_LEFT I_RUN I_TURN_LEFT I_RUN I_TURN_LEFT I_RUN I_TURN_LEFT I_RUN I_TURN_LEFT I_RUN I_TURN_LEFT I_RUN I_TURN_RIGHT I_WALK I_TURN_RIGHT I_WALK I_TURN_RIGHT I_WALK I_TURN_RIGHT I_WALK I_TURN_RIGHT I_WALK I_TURN_RIGHT I_WALK I_TURN_RIGHT I_WALK I_TURN_RIGHT I_WALK	 turn left run turn left run turn left run turn left run turn left run turn left run turn left run turn left run turn right walk turn right walk turn right walk turn right walk turn right walk turn right walk turn right walk turn right walk
look opposite right thrice after walk around right twice ->	I_TURN_RIGHT I_WALK I_TURN_RIGHT I_WALK I_TURN_RIGHT I_WALK I_TURN_RIGHT I_WALK I_TURN_RIGHT I_WALK I_TURN_RIGHT I_WALK I_TURN_RIGHT I_WALK I_TURN_RIGHT I_WALK I_TURN_RIGHT I_TURN_RIGHT I_LOOK I_TURN_RIGHT I_TURN_RIGHT I_LOOK I_TURN_RIGHT I_TURN_RIGHT I_LOOK	 turn right walk turn right walk turn right walk turn right walk turn right walk turn right walk turn right walk turn right turn right look turn right turn right look turn right turn right look
run around right thrice and turn left twice ->	I_TURN_RIGHT I_RUN I_TURN_RIGHT I_RUN I_TURN_RIGHT I_RUN I_TURN_RIGHT I_RUN I_TURN_RIGHT I_RUN I_TURN_RIGHT I_RUN I_TURN_RIGHT I_RUN I_TURN_RIGHT I_RUN I_TURN_RIGHT I_RUN I_TURN_RIGHT I_RUN I_TURN_RIGHT I_RUN I_TURN_RIGHT I_RUN I_TURN_LEFT I_TURN_LEFT	 turn right run turn right run turn right run turn right run turn right run turn right run turn right run turn right run turn right run turn left turn left
jump around left thrice after run twice ->	I_RUN I_RUN I_TURN_LEFT I_JUMP I_TURN_LEFT I_JUMP I_TURN_LEFT I_JUMP I_TURN_LEFT I_JUMP I_TURN_LEFT I_JUMP I_TURN_LEFT I_JUMP I_TURN_LEFT I_JUMP I_TURN_LEFT I_JUMP I_TURN_LEFT I_JUMP I_TURN_LEFT I_JUMP I_TURN_LEFT I_JUMP I_TURN_LEFT I_JUMP	 run run turn left jump turn left jump turn left jump turn left jump turn left jump turn left jump turn left jump turn left jump turn left jump turn left jump
turn around right thrice after look around left twice ->	I_TURN_LEFT I_LOOK I_TURN_LEFT I_LOOK I_TURN_LEFT I_LOOK I_TURN_LEFT I_LOOK I_TURN_LEFT I_LOOK I_TURN_LEFT I_LOOK I_TURN_LEFT I_LOOK I_TURN_LEFT I_LOOK I_TURN_RIGHT I_TURN_RIGHT I_TURN_RIGHT I_TURN_RIGHT I_TURN_RIGHT I_TURN_RIGHT I_TURN_RIGHT I_TURN_RIGHT I_TURN_RIGHT I_TURN_RIGHT I_TURN_RIGHT I_TURN_RIGHT	 turn left look turn left look turn left look turn left look turn left look turn left look turn left look turn left look turn left look turn right turn right turn right turn right turn right turn right turn right turn right turn right turn right
jump around left thrice after walk around left thrice ->	I_TURN_LEFT I_WALK I_TURN_LEFT I_WALK I_TURN_LEFT I_WALK I_TURN_LEFT I_WALK I_TURN_LEFT I_WALK I_TURN_LEFT I_WALK I_TURN_LEFT I_WALK I_TURN_LEFT I_WALK I_TURN_LEFT I_WALK I_TURN_LEFT I_WALK I_TURN_LEFT I_WALK I_TURN_LEFT I_WALK I_TURN_LEFT I_JUMP I_TURN_LEFT I_JUMP I_TURN_LEFT I_JUMP I_TURN_LEFT I_JUMP I_TURN_LEFT I_JUMP I_TURN_LEFT I_JUMP I_TURN_LEFT I_JUMP I_TURN_LEFT I_JUMP I_TURN_LEFT I_JUMP I_TURN_LEFT I_JUMP I_TURN_LEFT I_JUMP I_TURN_LEFT I_JUMP	 turn left walk turn left walk turn left walk turn left walk turn left walk turn left walk turn left jump turn left jump turn left jump turn left jump turn left jump turn left jump turn left jump turn left jump turn left jump turn left jump
look around left thrice and look left thrice ->	I_TURN_LEFT I_LOOK I_TURN_LEFT I_LOOK I_TURN_LEFT I_LOOK I_TURN_LEFT I_LOOK I_TURN_LEFT I_LOOK I_TURN_LEFT I_LOOK I_TURN_LEFT I_LOOK I_TURN_LEFT I_LOOK I_TURN_LEFT I_LOOK I_TURN_LEFT I_LOOK I_TURN_LEFT I_LOOK I_TURN_LEFT I_LOOK I_TURN_LEFT I_LOOK I_TURN_LEFT I_LOOK I_TURN_LEFT I_LOOK	 turn left look turn left look turn left look turn left look turn left look turn left look turn left look turn left look turn left look turn left look turn left look
jump twice and run around left thrice ->	I_JUMP I_JUMP I_TURN_LEFT I_RUN I_TURN_LEFT I_RUN I_TURN_LEFT I_RUN I_TURN_LEFT I_RUN I_TURN_LEFT I_RUN I_TURN_LEFT I_RUN I_TURN_LEFT I_RUN I_TURN_LEFT I_RUN I_TURN_LEFT I_RUN I_TURN_LEFT I_RUN I_TURN_LEFT I_RUN I_TURN_LEFT I_RUN	 jump jump turn left run turn left run turn left run turn left run turn left run turn left run turn left run turn left run turn left run
run opposite right thrice after run around right twice ->	I_TURN_RIGHT I_RUN I_TURN_RIGHT I_RUN I_TURN_RIGHT I_RUN I_TURN_RIGHT I_RUN I_TURN_RIGHT I_RUN I_TURN_RIGHT I_RUN I_TURN_RIGHT I_RUN I_TURN_RIGHT I_RUN I_TURN_RIGHT I_TURN_RIGHT I_RUN I_TURN_RIGHT I_TURN_RIGHT I_RUN I_TURN_RIGHT I_TURN_RIGHT I_RUN	 turn right run turn right run turn right run turn right run turn right run turn right run turn right run turn right run turn right run turn right turn right run turn right turn right run turn right turn right run
turn opposite left twice after jump around right thrice ->	I_TURN_RIGHT I_JUMP I_TURN_RIGHT I_JUMP I_TURN_RIGHT I_JUMP I_TURN_RIGHT I_JUMP I_TURN_RIGHT I_JUMP I_TURN_RIGHT I_JUMP I_TURN_RIGHT I_JUMP I_TURN_RIGHT I_JUMP I_TURN_RIGHT I_JUMP I_TURN_RIGHT I_JUMP I_TURN_RIGHT I_JUMP I_TURN_RIGHT I_JUMP I_TURN_LEFT I_TURN_LEFT I_TURN_LEFT I_TURN_LEFT	 turn right jump turn right jump turn right jump turn right jump turn right jump turn right jump turn right jump turn right jump turn left turn left turn left turn left turn left
run around right thrice after run around right twice ->	I_TURN_RIGHT I_RUN I_TURN_RIGHT I_RUN I_TURN_RIGHT I_RUN I_TURN_RIGHT I_RUN I_TURN_RIGHT I_RUN I_TURN_RIGHT I_RUN I_TURN_RIGHT I_RUN I_TURN_RIGHT I_RUN I_TURN_RIGHT I_RUN I_TURN_RIGHT I_RUN I_TURN_RIGHT I_RUN I_TURN_RIGHT I_RUN I_TURN_RIGHT I_RUN I_TURN_RIGHT I_RUN I_TURN_RIGHT I_RUN I_TURN_RIGHT I_RUN I_TURN_RIGHT I_RUN I_TURN_RIGHT I_RUN I_TURN_RIGHT I_RUN I_TURN_RIGHT I_RUN	 turn right run turn right run turn right run turn right run turn right run turn right run turn right run turn right run turn right run turn right run turn right run turn right run turn right run turn right run turn right run turn right run
look around left twice after look around right thrice ->	I_TURN_RIGHT I_LOOK I_TURN_RIGHT I_LOOK I_TURN_RIGHT I_LOOK I_TURN_RIGHT I_LOOK I_TURN_RIGHT I_LOOK I_TURN_RIGHT I_LOOK I_TURN_RIGHT I_LOOK I_TURN_RIGHT I_LOOK I_TURN_RIGHT I_LOOK I_TURN_RIGHT I_LOOK I_TURN_RIGHT I_LOOK I_TURN_RIGHT I_LOOK I_TURN_LEFT I_LOOK I_TURN_LEFT I_LOOK I_TURN_LEFT I_LOOK I_TURN_LEFT I_LOOK I_TURN_LEFT I_LOOK I_TURN_LEFT I_LOOK I_TURN_LEFT I_LOOK I_TURN_LEFT I_LOOK	 turn right look turn right look turn right look turn right look turn right look turn right look turn right look turn right look turn left look turn left look turn left look turn left look turn left look turn left look turn left look
run around right thrice and jump thrice ->	I_TURN_RIGHT I_RUN I_TURN_RIGHT I_RUN I_TURN_RIGHT I_RUN I_TURN_RIGHT I_RUN I_TURN_RIGHT I_RUN I_TURN_RIGHT I_RUN I_TURN_RIGHT I_RUN I_TURN_RIGHT I_RUN I_TURN_RIGHT I_RUN I_TURN_RIGHT I_RUN I_TURN_RIGHT I_RUN I_TURN_RIGHT I_RUN I_JUMP I_JUMP I_JUMP	 turn right run turn right run turn right run turn right run turn right run turn right run turn right run turn right run turn right run jump jump jump
look thrice after walk around right thrice ->	I_TURN_RIGHT I_WALK I_TURN_RIGHT I_WALK I_TURN_RIGHT I_WALK I_TURN_RIGHT I_WALK I_TURN_RIGHT I_WALK I_TURN_RIGHT I_WALK I_TURN_RIGHT I_WALK I_TURN_RIGHT I_WALK I_TURN_RIGHT I_WALK I_TURN_RIGHT I_WALK I_TURN_RIGHT I_WALK I_TURN_RIGHT I_WALK I_LOOK I_LOOK I_LOOK	 turn right walk turn right walk turn right walk turn right walk turn right walk turn right walk turn right walk turn right walk turn right walk look look look
run right thrice and look around right thrice ->	I_TURN_RIGHT I_RUN I_TURN_RIGHT I_RUN I_TURN_RIGHT I_RUN I_TURN_RIGHT I_LOOK I_TURN_RIGHT I_LOOK I_TURN_RIGHT I_LOOK I_TURN_RIGHT I_LOOK I_TURN_RIGHT I_LOOK I_TURN_RIGHT I_LOOK I_TURN_RIGHT I_LOOK I_TURN_RIGHT I_LOOK I_TURN_RIGHT I_LOOK I_TURN_RIGHT I_LOOK I_TURN_RIGHT I_LOOK I_TURN_RIGHT I_LOOK	 turn right run turn right run turn right run turn right look turn right look turn right look turn right look turn right look turn right look turn right look turn right look turn right look turn right look
jump around right twice and walk around left thrice ->	I_TURN_RIGHT I_JUMP I_TURN_RIGHT I_JUMP I_TURN_RIGHT I_JUMP I_TURN_RIGHT I_JUMP I_TURN_RIGHT I_JUMP I_TURN_RIGHT I_JUMP I_TURN_RIGHT I_JUMP I_TURN_RIGHT I_JUMP I_TURN_LEFT I_WALK I_TURN_LEFT I_WALK I_TURN_LEFT I_WALK I_TURN_LEFT I_WALK I_TURN_LEFT I_WALK I_TURN_LEFT I_WALK I_TURN_LEFT I_WALK I_TURN_LEFT I_WALK I_TURN_LEFT I_WALK I_TURN_LEFT I_WALK I_TURN_LEFT I_WALK I_TURN_LEFT I_WALK	 turn right jump turn right jump turn right jump turn right jump turn right jump turn right jump turn right jump turn right jump turn left walk turn left walk turn left walk turn left walk turn left walk turn left walk
look opposite right thrice and jump around right twice ->	I_TURN_RIGHT I_TURN_RIGHT I_LOOK I_TURN_RIGHT I_TURN_RIGHT I_LOOK I_TURN_RIGHT I_TURN_RIGHT I_LOOK I_TURN_RIGHT I_JUMP I_TURN_RIGHT I_JUMP I_TURN_RIGHT I_JUMP I_TURN_RIGHT I_JUMP I_TURN_RIGHT I_JUMP I_TURN_RIGHT I_JUMP I_TURN_RIGHT I_JUMP I_TURN_RIGHT I_JUMP	 turn right turn right look turn right turn right look turn right turn right look turn right jump turn right jump turn right jump turn right jump turn right jump turn right jump turn right jump turn right jump
walk around right thrice after run right ->	I_TURN_RIGHT I_RUN I_TURN_RIGHT I_WALK I_TURN_RIGHT I_WALK I_TURN_RIGHT I_WALK I_TURN_RIGHT I_WALK I_TURN_RIGHT I_WALK I_TURN_RIGHT I_WALK I_TURN_RIGHT I_WALK I_TURN_RIGHT I_WALK I_TURN_RIGHT I_WALK I_TURN_RIGHT I_WALK I_TURN_RIGHT I_WALK I_TURN_RIGHT I_WALK	 turn right run turn right walk turn right walk turn right walk turn right walk turn right walk turn right walk turn right walk turn right walk turn right walk
jump thrice after jump around left thrice ->	I_TURN_LEFT I_JUMP I_TURN_LEFT I_JUMP I_TURN_LEFT I_JUMP I_TURN_LEFT I_JUMP I_TURN_LEFT I_JUMP I_TURN_LEFT I_JUMP I_TURN_LEFT I_JUMP I_TURN_LEFT I_JUMP I_TURN_LEFT I_JUMP I_TURN_LEFT I_JUMP I_TURN_LEFT I_JUMP I_TURN_LEFT I_JUMP I_JUMP I_JUMP I_JUMP	 turn left jump turn left jump turn left jump turn left jump turn left jump turn left jump turn left jump turn left jump turn left jump jump jump jump
jump around left thrice and walk around right twice ->	I_TURN_LEFT I_JUMP I_TURN_LEFT I_JUMP I_TURN_LEFT I_JUMP I_TURN_LEFT I_JUMP I_TURN_LEFT I_JUMP I_TURN_LEFT I_JUMP I_TURN_LEFT I_JUMP I_TURN_LEFT I_JUMP I_TURN_LEFT I_JUMP I_TURN_LEFT I_JUMP I_TURN_LEFT I_JUMP I_TURN_LEFT I_JUMP I_TURN_RIGHT I_WALK I_TURN_RIGHT I_WALK I_TURN_RIGHT I_WALK I_TURN_RIGHT I_WALK I_TURN_RIGHT I_WALK I_TURN_RIGHT I_WALK I_TURN_RIGHT I_WALK I_TURN_RIGHT I_WALK	 turn left jump turn left jump turn left jump turn left jump turn left jump turn left jump turn left jump turn left jump turn left jump turn right walk turn right walk turn right walk turn right walk turn right walk
look around right thrice after look right ->	I_TURN_RIGHT I_LOOK I_TURN_RIGHT I_LOOK I_TURN_RIGHT I_LOOK I_TURN_RIGHT I_LOOK I_TURN_RIGHT I_LOOK I_TURN_RIGHT I_LOOK I_TURN_RIGHT I_LOOK I_TURN_RIGHT I_LOOK I_TURN_RIGHT I_LOOK I_TURN_RIGHT I_LOOK I_TURN_RIGHT I_LOOK I_TURN_RIGHT I_LOOK I_TURN_RIGHT I_LOOK	 turn right look turn right look turn right look turn right look turn right look turn right look turn right look turn right look turn right look turn right look
run around left thrice after jump opposite right twice ->	I_TURN_RIGHT I_TURN_RIGHT I_JUMP I_TURN_RIGHT I_TURN_RIGHT I_JUMP I_TURN_LEFT I_RUN I_TURN_LEFT I_RUN I_TURN_LEFT I_RUN I_TURN_LEFT I_RUN I_TURN_LEFT I_RUN I_TURN_LEFT I_RUN I_TURN_LEFT I_RUN I_TURN_LEFT I_RUN I_TURN_LEFT I_RUN I_TURN_LEFT I_RUN I_TURN_LEFT I_RUN I_TURN_LEFT I_RUN	 turn right turn right jump turn right turn right jump turn left run turn left run turn left run turn left run turn left run turn left run turn left run turn left run turn left run turn left run
jump opposite right twice after run around left thrice ->	I_TURN_LEFT I_RUN I_TURN_LEFT I_RUN I_TURN_LEFT I_RUN I_TURN_LEFT I_RUN I_TURN_LEFT I_RUN I_TURN_LEFT I_RUN I_TURN_LEFT I_RUN I_TURN_LEFT I_RUN I_TURN_LEFT I_RUN I_TURN_LEFT I_RUN I_TURN_LEFT I_RUN I_TURN_LEFT I_RUN I_TURN_RIGHT I_TURN_RIGHT I_JUMP I_TURN_RIGHT I_TURN_RIGHT I_JUMP	 turn left run turn left run turn left run turn left run turn left run turn left run turn left run turn left run turn right turn right jump turn right turn right jump
jump around right thrice after jump opposite right thrice ->	I_TURN_RIGHT I_TURN_RIGHT I_JUMP I_TURN_RIGHT I_TURN_RIGHT I_JUMP I_TURN_RIGHT I_TURN_RIGHT I_JUMP I_TURN_RIGHT I_JUMP I_TURN_RIGHT I_JUMP I_TURN_RIGHT I_JUMP I_TURN_RIGHT I_JUMP I_TURN_RIGHT I_JUMP I_TURN_RIGHT I_JUMP I_TURN_RIGHT I_JUMP I_TURN_RIGHT I_JUMP I_TURN_RIGHT I_JUMP I_TURN_RIGHT I_JUMP I_TURN_RIGHT I_JUMP I_TURN_RIGHT I_JUMP	 turn right turn right jump turn right turn right jump turn right turn right jump turn right jump turn right jump turn right jump turn right jump turn right jump turn right jump turn right jump turn right jump turn right jump
walk opposite right and walk around left thrice ->	I_TURN_RIGHT I_TURN_RIGHT I_WALK I_TURN_LEFT I_WALK I_TURN_LEFT I_WALK I_TURN_LEFT I_WALK I_TURN_LEFT I_WALK I_TURN_LEFT I_WALK I_TURN_LEFT I_WALK I_TURN_LEFT I_WALK I_TURN_LEFT I_WALK I_TURN_LEFT I_WALK I_TURN_LEFT I_WALK I_TURN_LEFT I_WALK I_TURN_LEFT I_WALK	 turn right turn right walk turn left walk turn left walk turn left walk turn left walk turn left walk turn left walk turn left walk turn left walk turn left walk
walk around left and walk around right thrice ->	I_TURN_LEFT I_WALK I_TURN_LEFT I_WALK I_TURN_LEFT I_WALK I_TURN_LEFT I_WALK I_TURN_RIGHT I_WALK I_TURN_RIGHT I_WALK I_TURN_RIGHT I_WALK I_TURN_RIGHT I_WALK I_TURN_RIGHT I_WALK I_TURN_RIGHT I_WALK I_TURN_RIGHT I_WALK I_TURN_RIGHT I_WALK I_TURN_RIGHT I_WALK I_TURN_RIGHT I_WALK I_TURN_RIGHT I_WALK I_TURN_RIGHT I_WALK	 turn left walk turn left walk turn left walk turn left walk turn right walk turn right walk turn right walk turn right walk turn right walk turn right walk turn right walk turn right walk turn right walk
turn left thrice after walk around left thrice ->	I_TURN_LEFT I_WALK I_TURN_LEFT I_WALK I_TURN_LEFT I_WALK I_TURN_LEFT I_WALK I_TURN_LEFT I_WALK I_TURN_LEFT I_WALK I_TURN_LEFT I_WALK I_TURN_LEFT I_WALK I_TURN_LEFT I_WALK I_TURN_LEFT I_WALK I_TURN_LEFT I_WALK I_TURN_LEFT I_WALK I_TURN_LEFT I_TURN_LEFT I_TURN_LEFT	 turn left walk turn left walk turn left walk turn left walk turn left walk turn left walk turn left walk turn left walk turn left walk turn left walk turn left turn left turn left turn left
run around right and look around right thrice ->	I_TURN_RIGHT I_RUN I_TURN_RIGHT I_RUN I_TURN_RIGHT I_RUN I_TURN_RIGHT I_RUN I_TURN_RIGHT I_LOOK I_TURN_RIGHT I_LOOK I_TURN_RIGHT I_LOOK I_TURN_RIGHT I_LOOK I_TURN_RIGHT I_LOOK I_TURN_RIGHT I_LOOK I_TURN_RIGHT I_LOOK I_TURN_RIGHT I_LOOK I_TURN_RIGHT I_LOOK I_TURN_RIGHT I_LOOK I_TURN_RIGHT I_LOOK I_TURN_RIGHT I_LOOK	 turn right run turn right run turn right run turn right run turn right run turn right look turn right look turn right look turn right look turn right look turn right look turn right look turn right look
run right thrice after look around left thrice ->	I_TURN_LEFT I_LOOK I_TURN_LEFT I_LOOK I_TURN_LEFT I_LOOK I_TURN_LEFT I_LOOK I_TURN_LEFT I_LOOK I_TURN_LEFT I_LOOK I_TURN_LEFT I_LOOK I_TURN_LEFT I_LOOK I_TURN_LEFT I_LOOK I_TURN_LEFT I_LOOK I_TURN_LEFT I_LOOK I_TURN_LEFT I_LOOK I_TURN_RIGHT I_RUN I_TURN_RIGHT I_RUN I_TURN_RIGHT I_RUN	 turn left look turn left look turn left look turn left look turn left look turn left look turn left look turn left look turn left look turn right run turn right run turn right run
look around right after jump around left thrice ->	I_TURN_LEFT I_JUMP I_TURN_LEFT I_JUMP I_TURN_LEFT I_JUMP I_TURN_LEFT I_JUMP I_TURN_LEFT I_JUMP I_TURN_LEFT I_JUMP I_TURN_LEFT I_JUMP I_TURN_LEFT I_JUMP I_TURN_LEFT I_JUMP I_TURN_LEFT I_JUMP I_TURN_LEFT I_JUMP I_TURN_LEFT I_JUMP I_TURN_RIGHT I_LOOK I_TURN_RIGHT I_LOOK I_TURN_RIGHT I_LOOK I_TURN_RIGHT I_LOOK	 turn left jump turn left jump turn left jump turn left jump turn left jump turn left jump turn left jump turn right look turn right look turn right look turn right look
run thrice and run around left thrice ->	I_RUN I_RUN I_RUN I_TURN_LEFT I_RUN I_TURN_LEFT I_RUN I_TURN_LEFT I_RUN I_TURN_LEFT I_RUN I_TURN_LEFT I_RUN I_TURN_LEFT I_RUN I_TURN_LEFT I_RUN I_TURN_LEFT I_RUN I_TURN_LEFT I_RUN I_TURN_LEFT I_RUN I_TURN_LEFT I_RUN I_TURN_LEFT I_RUN	 run run run turn left run turn left run turn left run turn left run turn left run turn left run turn left run turn left run turn left run
look opposite right thrice after walk around right thrice ->	I_TURN_RIGHT I_WALK I_TURN_RIGHT I_WALK I_TURN_RIGHT I_WALK I_TURN_RIGHT I_WALK I_TURN_RIGHT I_WALK I_TURN_RIGHT I_WALK I_TURN_RIGHT I_WALK I_TURN_RIGHT I_WALK I_TURN_RIGHT I_WALK I_TURN_RIGHT I_WALK I_TURN_RIGHT I_WALK I_TURN_RIGHT I_WALK I_TURN_RIGHT I_TURN_RIGHT I_LOOK I_TURN_RIGHT I_TURN_RIGHT I_LOOK I_TURN_RIGHT I_TURN_RIGHT I_LOOK	 turn right walk turn right walk turn right walk turn right walk turn right walk turn right walk turn right walk turn right walk turn right walk turn right turn right look turn right turn right look turn right turn right look
walk around right thrice and jump opposite left thrice ->	I_TURN_RIGHT I_WALK I_TURN_RIGHT I_WALK I_TURN_RIGHT I_WALK I_TURN_RIGHT I_WALK I_TURN_RIGHT I_WALK I_TURN_RIGHT I_WALK I_TURN_RIGHT I_WALK I_TURN_RIGHT I_WALK I_TURN_RIGHT I_WALK I_TURN_RIGHT I_WALK I_TURN_RIGHT I_WALK I_TURN_RIGHT I_WALK I_TURN_LEFT I_TURN_LEFT I_JUMP I_TURN_LEFT I_TURN_LEFT I_JUMP I_TURN_LEFT I_TURN_LEFT I_JUMP	 turn right walk turn right walk turn right walk turn right walk turn right walk turn right walk turn right walk turn right walk turn left turn left jump turn left turn left jump turn left turn left jump
look around right twice and run opposite left thrice ->	I_TURN_RIGHT I_LOOK I_TURN_RIGHT I_LOOK I_TURN_RIGHT I_LOOK I_TURN_RIGHT I_LOOK I_TURN_RIGHT I_LOOK I_TURN_RIGHT I_LOOK I_TURN_RIGHT I_LOOK I_TURN_RIGHT I_LOOK I_TURN_LEFT I_TURN_LEFT I_RUN I_TURN_LEFT I_TURN_LEFT I_RUN I_TURN_LEFT I_TURN_LEFT I_RUN	 turn right look turn right look turn right look turn right look turn right look turn right look turn right look turn right look turn left turn left run turn left turn left run turn left turn left run
turn opposite right after walk around right thrice ->	I_TURN_RIGHT I_WALK I_TURN_RIGHT I_WALK I_TURN_RIGHT I_WALK I_TURN_RIGHT I_WALK I_TURN_RIGHT I_WALK I_TURN_RIGHT I_WALK I_TURN_RIGHT I_WALK I_TURN_RIGHT I_WALK I_TURN_RIGHT I_WALK I_TURN_RIGHT I_WALK I_TURN_RIGHT I_WALK I_TURN_RIGHT I_WALK I_TURN_RIGHT I_TURN_RIGHT	 turn right walk turn right walk turn right walk turn right walk turn right walk turn right walk turn right walk turn right walk turn right turn right
run opposite right thrice after look around right thrice ->	I_TURN_RIGHT I_LOOK I_TURN_RIGHT I_LOOK I_TURN_RIGHT I_LOOK I_TURN_RIGHT I_LOOK I_TURN_RIGHT I_LOOK I_TURN_RIGHT I_LOOK I_TURN_RIGHT I_LOOK I_TURN_RIGHT I_LOOK I_TURN_RIGHT I_LOOK I_TURN_RIGHT I_LOOK I_TURN_RIGHT I_LOOK I_TURN_RIGHT I_LOOK I_TURN_RIGHT I_TURN_RIGHT I_RUN I_TURN_RIGHT I_TURN_RIGHT I_RUN I_TURN_RIGHT I_TURN_RIGHT I_RUN	 turn right look turn right look turn right look turn right look turn right look turn right look turn right look turn right look turn right turn right run turn right turn right run turn right turn right run
walk around left twice after run opposite left thrice ->	I_TURN_LEFT I_TURN_LEFT I_RUN I_TURN_LEFT I_TURN_LEFT I_RUN I_TURN_LEFT I_TURN_LEFT I_RUN I_TURN_LEFT I_WALK I_TURN_LEFT I_WALK I_TURN_LEFT I_WALK I_TURN_LEFT I_WALK I_TURN_LEFT I_WALK I_TURN_LEFT I_WALK I_TURN_LEFT I_WALK I_TURN_LEFT I_WALK	 turn left turn left run turn left turn left run turn left turn left run turn left walk turn left walk turn left walk turn left walk turn left walk turn left walk turn left walk
walk right thrice and run around right thrice ->	I_TURN_RIGHT I_WALK I_TURN_RIGHT I_WALK I_TURN_RIGHT I_WALK I_TURN_RIGHT I_RUN I_TURN_RIGHT I_RUN I_TURN_RIGHT I_RUN I_TURN_RIGHT I_RUN I_TURN_RIGHT I_RUN I_TURN_RIGHT I_RUN I_TURN_RIGHT I_RUN I_TURN_RIGHT I_RUN I_TURN_RIGHT I_RUN I_TURN_RIGHT I_RUN I_TURN_RIGHT I_RUN I_TURN_RIGHT I_RUN	 turn right walk turn right walk turn right walk turn right run turn right run turn right run turn right run turn right run turn right run turn right run turn right run turn right run turn right run
turn opposite left twice after walk around right thrice ->	I_TURN_RIGHT I_WALK I_TURN_RIGHT I_WALK I_TURN_RIGHT I_WALK I_TURN_RIGHT I_WALK I_TURN_RIGHT I_WALK I_TURN_RIGHT I_WALK I_TURN_RIGHT I_WALK I_TURN_RIGHT I_WALK I_TURN_RIGHT I_WALK I_TURN_RIGHT I_WALK I_TURN_RIGHT I_WALK I_TURN_RIGHT I_WALK I_TURN_LEFT I_TURN_LEFT I_TURN_LEFT I_TURN_LEFT	 turn right walk turn right walk turn right walk turn right walk turn right walk turn right walk turn right walk turn right walk turn right walk turn left turn left turn left turn left
look around right twice and walk around right twice ->	I_TURN_RIGHT I_LOOK I_TURN_RIGHT I_LOOK I_TURN_RIGHT I_LOOK I_TURN_RIGHT I_LOOK I_TURN_RIGHT I_LOOK I_TURN_RIGHT I_LOOK I_TURN_RIGHT I_LOOK I_TURN_RIGHT I_LOOK I_TURN_RIGHT I_WALK I_TURN_RIGHT I_WALK I_TURN_RIGHT I_WALK I_TURN_RIGHT I_WALK I_TURN_RIGHT I_WALK I_TURN_RIGHT I_WALK I_TURN_RIGHT I_WALK I_TURN_RIGHT I_WALK	 turn right look turn right look turn right look turn right look turn right look turn right look turn right look turn right look turn right walk turn right walk turn right walk turn right walk turn right walk turn right walk
run opposite right thrice and run around left twice ->	I_TURN_RIGHT I_TURN_RIGHT I_RUN I_TURN_RIGHT I_TURN_RIGHT I_RUN I_TURN_RIGHT I_TURN_RIGHT I_RUN I_TURN_LEFT I_RUN I_TURN_LEFT I_RUN I_TURN_LEFT I_RUN I_TURN_LEFT I_RUN I_TURN_LEFT I_RUN I_TURN_LEFT I_RUN I_TURN_LEFT I_RUN I_TURN_LEFT I_RUN	 turn right turn right run turn right turn right run turn right turn right run turn left run turn left run turn left run turn left run turn left run turn left run turn left run
look opposite left thrice and run around right twice ->	I_TURN_LEFT I_TURN_LEFT I_LOOK I_TURN_LEFT I_TURN_LEFT I_LOOK I_TURN_LEFT I_TURN_LEFT I_LOOK I_TURN_RIGHT I_RUN I_TURN_RIGHT I_RUN I_TURN_RIGHT I_RUN I_TURN_RIGHT I_RUN I_TURN_RIGHT I_RUN I_TURN_RIGHT I_RUN I_TURN_RIGHT I_RUN I_TURN_RIGHT I_RUN	 turn left turn left look turn left turn left look turn left turn left look turn right run turn right run turn right run turn right run turn right run turn right run turn right run turn right run
turn opposite right twice after run around left thrice ->	I_TURN_LEFT I_RUN I_TURN_LEFT I_RUN I_TURN_LEFT I_RUN I_TURN_LEFT I_RUN I_TURN_LEFT I_RUN I_TURN_LEFT I_RUN I_TURN_LEFT I_RUN I_TURN_LEFT I_RUN I_TURN_LEFT I_RUN I_TURN_LEFT I_RUN I_TURN_LEFT I_RUN I_TURN_LEFT I_RUN I_TURN_RIGHT I_TURN_RIGHT I_TURN_RIGHT I_TURN_RIGHT	 turn left run turn left run turn left run turn left run turn left run turn left run turn left run turn left run turn left run turn right turn right turn right turn right
jump around right thrice after look left ->	I_TURN_LEFT I_LOOK I_TURN_RIGHT I_JUMP I_TURN_RIGHT I_JUMP I_TURN_RIGHT I_JUMP I_TURN_RIGHT I_JUMP I_TURN_RIGHT I_JUMP I_TURN_RIGHT I_JUMP I_TURN_RIGHT I_JUMP I_TURN_RIGHT I_JUMP I_TURN_RIGHT I_JUMP I_TURN_RIGHT I_JUMP I_TURN_RIGHT I_JUMP I_TURN_RIGHT I_JUMP	 turn left look turn right jump turn right jump turn right jump turn right jump turn right jump turn right jump turn right jump turn right jump turn right jump
walk around left after jump around right twice ->	I_TURN_RIGHT I_JUMP I_TURN_RIGHT I_JUMP I_TURN_RIGHT I_JUMP I_TURN_RIGHT I_JUMP I_TURN_RIGHT I_JUMP I_TURN_RIGHT I_JUMP I_TURN_RIGHT I_JUMP I_TURN_RIGHT I_JUMP I_TURN_LEFT I_WALK I_TURN_LEFT I_WALK I_TURN_LEFT I_WALK I_TURN_LEFT I_WALK	 turn right jump turn right jump turn right jump turn right jump turn right jump turn right jump turn right jump turn left walk turn left walk turn left walk turn left walk
jump around left thrice after jump left twice ->	I_TURN_LEFT I_JUMP I_TURN_LEFT I_JUMP I_TURN_LEFT I_JUMP I_TURN_LEFT I_JUMP I_TURN_LEFT I_JUMP I_TURN_LEFT I_JUMP I_TURN_LEFT I_JUMP I_TURN_LEFT I_JUMP I_TURN_LEFT I_JUMP I_TURN_LEFT I_JUMP I_TURN_LEFT I_JUMP I_TURN_LEFT I_JUMP I_TURN_LEFT I_JUMP I_TURN_LEFT I_JUMP	 turn left jump turn left jump turn left jump turn left jump turn left jump turn left jump turn left jump turn left jump turn left jump turn left jump turn left jump turn left jump turn left jump
jump around right thrice after look around right twice ->	I_TURN_RIGHT I_LOOK I_TURN_RIGHT I_LOOK I_TURN_RIGHT I_LOOK I_TURN_RIGHT I_LOOK I_TURN_RIGHT I_LOOK I_TURN_RIGHT I_LOOK I_TURN_RIGHT I_LOOK I_TURN_RIGHT I_LOOK I_TURN_RIGHT I_JUMP I_TURN_RIGHT I_JUMP I_TURN_RIGHT I_JUMP I_TURN_RIGHT I_JUMP I_TURN_RIGHT I_JUMP I_TURN_RIGHT I_JUMP I_TURN_RIGHT I_JUMP I_TURN_RIGHT I_JUMP I_TURN_RIGHT I_JUMP I_TURN_RIGHT I_JUMP I_TURN_RIGHT I_JUMP I_TURN_RIGHT I_JUMP	 turn right look turn right look turn right look turn right look turn right look turn right look turn right look turn right look turn right jump turn right jump turn right jump turn right jump turn right jump turn right jump turn right jump turn right jump
look around left thrice after jump right twice ->	I_TURN_RIGHT I_JUMP I_TURN_RIGHT I_JUMP I_TURN_LEFT I_LOOK I_TURN_LEFT I_LOOK I_TURN_LEFT I_LOOK I_TURN_LEFT I_LOOK I_TURN_LEFT I_LOOK I_TURN_LEFT I_LOOK I_TURN_LEFT I_LOOK I_TURN_LEFT I_LOOK I_TURN_LEFT I_LOOK I_TURN_LEFT I_LOOK I_TURN_LEFT I_LOOK I_TURN_LEFT I_LOOK	 turn right jump turn right jump turn left look turn left look turn left look turn left look turn left look turn left look turn left look turn left look turn left look turn left look
run left twice and jump around right thrice ->	I_TURN_LEFT I_RUN I_TURN_LEFT I_RUN I_TURN_RIGHT I_JUMP I_TURN_RIGHT I_JUMP I_TURN_RIGHT I_JUMP I_TURN_RIGHT I_JUMP I_TURN_RIGHT I_JUMP I_TURN_RIGHT I_JUMP I_TURN_RIGHT I_JUMP I_TURN_RIGHT I_JUMP I_TURN_RIGHT I_JUMP I_TURN_RIGHT I_JUMP I_TURN_RIGHT I_JUMP I_TURN_RIGHT I_JUMP	 turn left run turn left run turn right jump turn right jump turn right jump turn right jump turn right jump turn right jump turn right jump turn right jump
look right thrice and look around right thrice ->	I_TURN_RIGHT I_LOOK I_TURN_RIGHT I_LOOK I_TURN_RIGHT I_LOOK I_TURN_RIGHT I_LOOK I_TURN_RIGHT I_LOOK I_TURN_RIGHT I_LOOK I_TURN_RIGHT I_LOOK I_TURN_RIGHT I_LOOK I_TURN_RIGHT I_LOOK I_TURN_RIGHT I_LOOK I_TURN_RIGHT I_LOOK I_TURN_RIGHT I_LOOK I_TURN_RIGHT I_LOOK I_TURN_RIGHT I_LOOK I_TURN_RIGHT I_LOOK	 turn right look turn right look turn right look turn right look turn right look turn right look turn right look turn right look turn right look turn right look turn right look turn right look turn right look
run around left after run around right twice ->	I_TURN_RIGHT I_RUN I_TURN_RIGHT I_RUN I_TURN_RIGHT I_RUN I_TURN_RIGHT I_RUN I_TURN_RIGHT I_RUN I_TURN_RIGHT I_RUN I_TURN_RIGHT I_RUN I_TURN_RIGHT I_RUN I_TURN_LEFT I_RUN I_TURN_LEFT I_RUN I_TURN_LEFT I_RUN I_TURN_LEFT I_RUN	 turn right run turn right run turn right run turn right run turn right run turn right run turn right run turn left run turn left run turn left run turn left run turn left run
run around left thrice after run left twice ->	I_TURN_LEFT I_RUN I_TURN_LEFT I_RUN I_TURN_LEFT I_RUN I_TURN_LEFT I_RUN I_TURN_LEFT I_RUN I_TURN_LEFT I_RUN I_TURN_LEFT I_RUN I_TURN_LEFT I_RUN I_TURN_LEFT I_RUN I_TURN_LEFT I_RUN I_TURN_LEFT I_RUN I_TURN_LEFT I_RUN I_TURN_LEFT I_RUN I_TURN_LEFT I_RUN	 turn left run turn left run turn left run turn left run turn left run turn left run turn left run turn left run turn left run turn left run turn left run turn left run turn left run
look around right thrice after run around left twice ->	I_TURN_LEFT I_RUN I_TURN_LEFT I_RUN I_TURN_LEFT I_RUN I_TURN_LEFT I_RUN I_TURN_LEFT I_RUN I_TURN_LEFT I_RUN I_TURN_LEFT I_RUN I_TURN_LEFT I_RUN I_TURN_RIGHT I_LOOK I_TURN_RIGHT I_LOOK I_TURN_RIGHT I_LOOK I_TURN_RIGHT I_LOOK I_TURN_RIGHT I_LOOK I_TURN_RIGHT I_LOOK I_TURN_RIGHT I_LOOK I_TURN_RIGHT I_LOOK I_TURN_RIGHT I_LOOK I_TURN_RIGHT I_LOOK I_TURN_RIGHT I_LOOK I_TURN_RIGHT I_LOOK	 turn left run turn left run turn left run turn left run turn left run turn left run turn left run turn left run turn right look turn right look turn right look turn right look turn right look turn right look turn right look turn right look turn right look turn right look
turn left thrice and jump around right thrice ->	I_TURN_LEFT I_TURN_LEFT I_TURN_LEFT I_TURN_RIGHT I_JUMP I_TURN_RIGHT I_JUMP I_TURN_RIGHT I_JUMP I_TURN_RIGHT I_JUMP I_TURN_RIGHT I_JUMP I_TURN_RIGHT I_JUMP I_TURN_RIGHT I_JUMP I_TURN_RIGHT I_JUMP I_TURN_RIGHT I_JUMP I_TURN_RIGHT I_JUMP I_TURN_RIGHT I_JUMP I_TURN_RIGHT I_JUMP	 turn left turn left turn left turn right jump turn right jump turn right jump turn right jump turn right jump turn right jump turn right jump turn right jump turn right jump
look around left thrice after walk left thrice ->	I_TURN_LEFT I_WALK I_TURN_LEFT I_WALK I_TURN_LEFT I_WALK I_TURN_LEFT I_LOOK I_TURN_LEFT I_LOOK I_TURN_LEFT I_LOOK I_TURN_LEFT I_LOOK I_TURN_LEFT I_LOOK I_TURN_LEFT I_LOOK I_TURN_LEFT I_LOOK I_TURN_LEFT I_LOOK I_TURN_LEFT I_LOOK I_TURN_LEFT I_LOOK I_TURN_LEFT I_LOOK I_TURN_LEFT I_LOOK	 turn left walk turn left walk turn left walk turn left look turn left look turn left look turn left look turn left look turn left look turn left look turn left look turn left look turn left look
run right twice and walk around left thrice ->	I_TURN_RIGHT I_RUN I_TURN_RIGHT I_RUN I_TURN_LEFT I_WALK I_TURN_LEFT I_WALK I_TURN_LEFT I_WALK I_TURN_LEFT I_WALK I_TURN_LEFT I_WALK I_TURN_LEFT I_WALK I_TURN_LEFT I_WALK I_TURN_LEFT I_WALK I_TURN_LEFT I_WALK I_TURN_LEFT I_WALK I_TURN_LEFT I_WALK I_TURN_LEFT I_WALK	 turn right run turn right run turn left walk turn left walk turn left walk turn left walk turn left walk turn left walk turn left walk turn left walk turn left walk
run around left thrice after look opposite right twice ->	I_TURN_RIGHT I_TURN_RIGHT I_LOOK I_TURN_RIGHT I_TURN_RIGHT I_LOOK I_TURN_LEFT I_RUN I_TURN_LEFT I_RUN I_TURN_LEFT I_RUN I_TURN_LEFT I_RUN I_TURN_LEFT I_RUN I_TURN_LEFT I_RUN I_TURN_LEFT I_RUN I_TURN_LEFT I_RUN I_TURN_LEFT I_RUN I_TURN_LEFT I_RUN I_TURN_LEFT I_RUN I_TURN_LEFT I_RUN	 turn right turn right look turn right turn right look turn left run turn left run turn left run turn left run turn left run turn left run turn left run turn left run turn left run turn left run turn left run
run opposite left thrice after look around right twice ->	I_TURN_RIGHT I_LOOK I_TURN_RIGHT I_LOOK I_TURN_RIGHT I_LOOK I_TURN_RIGHT I_LOOK I_TURN_RIGHT I_LOOK I_TURN_RIGHT I_LOOK I_TURN_RIGHT I_LOOK I_TURN_RIGHT I_LOOK I_TURN_LEFT I_TURN_LEFT I_RUN I_TURN_LEFT I_TURN_LEFT I_RUN I_TURN_LEFT I_TURN_LEFT I_RUN	 turn right look turn right look turn right look turn right look turn right look turn right look turn right look turn right look turn left turn left run turn left turn left run turn left turn left run
look around left thrice after walk around left twice ->	I_TURN_LEFT I_WALK I_TURN_LEFT I_WALK I_TURN_LEFT I_WALK I_TURN_LEFT I_WALK I_TURN_LEFT I_WALK I_TURN_LEFT I_WALK I_TURN_LEFT I_WALK I_TURN_LEFT I_WALK I_TURN_LEFT I_LOOK I_TURN_LEFT I_LOOK I_TURN_LEFT I_LOOK I_TURN_LEFT I_LOOK I_TURN_LEFT I_LOOK I_TURN_LEFT I_LOOK I_TURN_LEFT I_LOOK I_TURN_LEFT I_LOOK I_TURN_LEFT I_LOOK I_TURN_LEFT I_LOOK I_TURN_LEFT I_LOOK I_TURN_LEFT I_LOOK	 turn left walk turn left walk turn left walk turn left walk turn left walk turn left walk turn left walk turn left walk turn left look turn left look turn left look turn left look turn left look turn left look turn left look turn left look turn left look turn left look
look around right twice after walk around right twice ->	I_TURN_RIGHT I_WALK I_TURN_RIGHT I_WALK I_TURN_RIGHT I_WALK I_TURN_RIGHT I_WALK I_TURN_RIGHT I_WALK I_TURN_RIGHT I_WALK I_TURN_RIGHT I_WALK I_TURN_RIGHT I_WALK I_TURN_RIGHT I_LOOK I_TURN_RIGHT I_LOOK I_TURN_RIGHT I_LOOK I_TURN_RIGHT I_LOOK I_TURN_RIGHT I_LOOK I_TURN_RIGHT I_LOOK I_TURN_RIGHT I_LOOK I_TURN_RIGHT I_LOOK	 turn right walk turn right walk turn right walk turn right walk turn right walk turn right walk turn right walk turn right look turn right look turn right look turn right look turn right look turn right look turn right look
jump thrice and run around left thrice ->	I_JUMP I_JUMP I_JUMP I_TURN_LEFT I_RUN I_TURN_LEFT I_RUN I_TURN_LEFT I_RUN I_TURN_LEFT I_RUN I_TURN_LEFT I_RUN I_TURN_LEFT I_RUN I_TURN_LEFT I_RUN I_TURN_LEFT I_RUN I_TURN_LEFT I_RUN I_TURN_LEFT I_RUN I_TURN_LEFT I_RUN I_TURN_LEFT I_RUN	 jump jump jump turn left run turn left run turn left run turn left run turn left run turn left run turn left run turn left run turn left run
look thrice and run around left thrice ->	I_LOOK I_LOOK I_LOOK I_TURN_LEFT I_RUN I_TURN_LEFT I_RUN I_TURN_LEFT I_RUN I_TURN_LEFT I_RUN I_TURN_LEFT I_RUN I_TURN_LEFT I_RUN I_TURN_LEFT I_RUN I_TURN_LEFT I_RUN I_TURN_LEFT I_RUN I_TURN_LEFT I_RUN I_TURN_LEFT I_RUN I_TURN_LEFT I_RUN	 look look look turn left run turn left run turn left run turn left run turn left run turn left run turn left run turn left run turn left run
look around left twice and turn around left thrice ->	I_TURN_LEFT I_LOOK I_TURN_LEFT I_LOOK I_TURN_LEFT I_LOOK I_TURN_LEFT I_LOOK I_TURN_LEFT I_LOOK I_TURN_LEFT I_LOOK I_TURN_LEFT I_LOOK I_TURN_LEFT I_LOOK I_TURN_LEFT I_TURN_LEFT I_TURN_LEFT I_TURN_LEFT I_TURN_LEFT I_TURN_LEFT I_TURN_LEFT I_TURN_LEFT I_TURN_LEFT I_TURN_LEFT I_TURN_LEFT I_TURN_LEFT	 turn left look turn left look turn left look turn left look turn left look turn left look turn left look turn left look turn left look turn left turn left turn left turn left turn left turn left turn left turn left turn left turn left turn left turn left turn left
look around left thrice and turn opposite right thrice ->	I_TURN_LEFT I_LOOK I_TURN_LEFT I_LOOK I_TURN_LEFT I_LOOK I_TURN_LEFT I_LOOK I_TURN_LEFT I_LOOK I_TURN_LEFT I_LOOK I_TURN_LEFT I_LOOK I_TURN_LEFT I_LOOK I_TURN_LEFT I_LOOK I_TURN_LEFT I_LOOK I_TURN_LEFT I_LOOK I_TURN_LEFT I_LOOK I_TURN_RIGHT I_TURN_RIGHT I_TURN_RIGHT I_TURN_RIGHT I_TURN_RIGHT I_TURN_RIGHT	 turn left look turn left look turn left look turn left look turn left look turn left look turn left look turn left look turn left look turn right turn right turn right turn right turn right turn right
look around right twice after run around left ->	I_TURN_LEFT I_RUN I_TURN_LEFT I_RUN I_TURN_LEFT I_RUN I_TURN_LEFT I_RUN I_TURN_RIGHT I_LOOK I_TURN_RIGHT I_LOOK I_TURN_RIGHT I_LOOK I_TURN_RIGHT I_LOOK I_TURN_RIGHT I_LOOK I_TURN_RIGHT I_LOOK I_TURN_RIGHT I_LOOK I_TURN_RIGHT I_LOOK	 turn left run turn left run turn left run turn left run turn right look turn right look turn right look turn right look turn right look turn right look turn right look turn right look
walk right after walk around right thrice ->	I_TURN_RIGHT I_WALK I_TURN_RIGHT I_WALK I_TURN_RIGHT I_WALK I_TURN_RIGHT I_WALK I_TURN_RIGHT I_WALK I_TURN_RIGHT I_WALK I_TURN_RIGHT I_WALK I_TURN_RIGHT I_WALK I_TURN_RIGHT I_WALK I_TURN_RIGHT I_WALK I_TURN_RIGHT I_WALK I_TURN_RIGHT I_WALK I_TURN_RIGHT I_WALK	 turn right walk turn right walk turn right walk turn right walk turn right walk turn right walk turn right walk turn right walk turn right walk turn right walk
walk opposite right thrice and walk around right thrice ->	I_TURN_RIGHT I_TURN_RIGHT I_WALK I_TURN_RIGHT I_TURN_RIGHT I_WALK I_TURN_RIGHT I_TURN_RIGHT I_WALK I_TURN_RIGHT I_WALK I_TURN_RIGHT I_WALK I_TURN_RIGHT I_WALK I_TURN_RIGHT I_WALK I_TURN_RIGHT I_WALK I_TURN_RIGHT I_WALK I_TURN_RIGHT I_WALK I_TURN_RIGHT I_WALK I_TURN_RIGHT I_WALK I_TURN_RIGHT I_WALK I_TURN_RIGHT I_WALK I_TURN_RIGHT I_WALK	 turn right turn right walk turn right turn right walk turn right turn right walk turn right walk turn right walk turn right walk turn right walk turn right walk turn right walk turn right walk turn right walk turn right walk
run around right thrice and jump around right ->	I_TURN_RIGHT I_RUN I_TURN_RIGHT I_RUN I_TURN_RIGHT I_RUN I_TURN_RIGHT I_RUN I_TURN_RIGHT I_RUN I_TURN_RIGHT I_RUN I_TURN_RIGHT I_RUN I_TURN_RIGHT I_RUN I_TURN_RIGHT I_RUN I_TURN_RIGHT I_RUN I_TURN_RIGHT I_RUN I_TURN_RIGHT I_RUN I_TURN_RIGHT I_JUMP I_TURN_RIGHT I_JUMP I_TURN_RIGHT I_JUMP I_TURN_RIGHT I_JUMP	 turn right run turn right run turn right run turn right run turn right run turn right run turn right run turn right run turn right run turn right jump turn right jump turn right jump turn right jump
walk around left thrice after look right thrice ->	I_TURN_RIGHT I_LOOK I_TURN_RIGHT I_LOOK I_TURN_RIGHT I_LOOK I_TURN_LEFT I_WALK I_TURN_LEFT I_WALK I_TURN_LEFT I_WALK I_TURN_LEFT I_WALK I_TURN_LEFT I_WALK I_TURN_LEFT I_WALK I_TURN_LEFT I_WALK I_TURN_LEFT I_WALK I_TURN_LEFT I_WALK I_TURN_LEFT I_WALK I_TURN_LEFT I_WALK I_TURN_LEFT I_WALK	 turn right look turn right look turn right look turn left walk turn left walk turn left walk turn left walk turn left walk turn left walk turn left walk turn left walk turn left walk turn left walk
look around left thrice and walk around left twice ->	I_TURN_LEFT I_LOOK I_TURN_LEFT I_LOOK I_TURN_LEFT I_LOOK I_TURN_LEFT I_LOOK I_TURN_LEFT I_LOOK I_TURN_LEFT I_LOOK I_TURN_LEFT I_LOOK I_TURN_LEFT I_LOOK I_TURN_LEFT I_LOOK I_TURN_LEFT I_LOOK I_TURN_LEFT I_LOOK I_TURN_LEFT I_LOOK I_TURN_LEFT I_WALK I_TURN_LEFT I_WALK I_TURN_LEFT I_WALK I_TURN_LEFT I_WALK I_TURN_LEFT I_WALK I_TURN_LEFT I_WALK I_TURN_LEFT I_WALK I_TURN_LEFT I_WALK	 turn left look turn left look turn left look turn left look turn left look turn left look turn left look turn left look turn left look turn left look turn left walk turn left walk turn left walk turn left walk
jump around left thrice after run opposite left thrice ->	I_TURN_LEFT I_TURN_LEFT I_RUN I_TURN_LEFT I_TURN_LEFT I_RUN I_TURN_LEFT I_TURN_LEFT I_RUN I_TURN_LEFT I_JUMP I_TURN_LEFT I_JUMP I_TURN_LEFT I_JUMP I_TURN_LEFT I_JUMP I_TURN_LEFT I_JUMP I_TURN_LEFT I_JUMP I_TURN_LEFT I_JUMP I_TURN_LEFT I_JUMP I_TURN_LEFT I_JUMP I_TURN_LEFT I_JUMP I_TURN_LEFT I_JUMP I_TURN_LEFT I_JUMP	 turn left turn left run turn left turn left run turn left turn left run turn left jump turn left jump turn left jump turn left jump turn left jump turn left jump turn left jump turn left jump turn left jump
look around left thrice and walk around right thrice ->	I_TURN_LEFT I_LOOK I_TURN_LEFT I_LOOK I_TURN_LEFT I_LOOK I_TURN_LEFT I_LOOK I_TURN_LEFT I_LOOK I_TURN_LEFT I_LOOK I_TURN_LEFT I_LOOK I_TURN_LEFT I_LOOK I_TURN_LEFT I_LOOK I_TURN_LEFT I_LOOK I_TURN_LEFT I_LOOK I_TURN_LEFT I_LOOK I_TURN_RIGHT I_WALK I_TURN_RIGHT I_WALK I_TURN_RIGHT I_WALK I_TURN_RIGHT I_WALK I_TURN_RIGHT I_WALK I_TURN_RIGHT I_WALK I_TURN_RIGHT I_WALK I_TURN_RIGHT I_WALK I_TURN_RIGHT I_WALK I_TURN_RIGHT I_WALK I_TURN_RIGHT I_WALK I_TURN_RIGHT I_WALK	 turn left look turn left look turn left look turn left look turn left look turn left look turn left look turn left look turn right walk turn right walk turn right walk turn right walk turn right walk turn right walk turn right walk turn right walk turn right walk
run around left thrice after turn around left twice ->	I_TURN_LEFT I_TURN_LEFT I_TURN_LEFT I_TURN_LEFT I_TURN_LEFT I_TURN_LEFT I_TURN_LEFT I_TURN_LEFT I_TURN_LEFT I_RUN I_TURN_LEFT I_RUN I_TURN_LEFT I_RUN I_TURN_LEFT I_RUN I_TURN_LEFT I_RUN I_TURN_LEFT I_RUN I_TURN_LEFT I_RUN I_TURN_LEFT I_RUN I_TURN_LEFT I_RUN I_TURN_LEFT I_RUN I_TURN_LEFT I_RUN I_TURN_LEFT I_RUN	 turn left turn left turn left turn left turn left turn left turn left turn left run turn left run turn left run turn left run turn left run turn left run turn left run turn left run turn left run turn left run
walk around right after walk around right twice ->	I_TURN_RIGHT I_WALK I_TURN_RIGHT I_WALK I_TURN_RIGHT I_WALK I_TURN_RIGHT I_WALK I_TURN_RIGHT I_WALK I_TURN_RIGHT I_WALK I_TURN_RIGHT I_WALK I_TURN_RIGHT I_WALK I_TURN_RIGHT I_WALK I_TURN_RIGHT I_WALK I_TURN_RIGHT I_WALK I_TURN_RIGHT I_WALK	 turn right walk turn right walk turn right walk turn right walk turn right walk turn right walk turn right walk turn right walk turn right walk turn right walk
look around left thrice after run opposite left ->	I_TURN_LEFT I_TURN_LEFT I_RUN I_TURN_LEFT I_LOOK I_TURN_LEFT I_LOOK I_TURN_LEFT I_LOOK I_TURN_LEFT I_LOOK I_TURN_LEFT I_LOOK I_TURN_LEFT I_LOOK I_TURN_LEFT I_LOOK I_TURN_LEFT I_LOOK I_TURN_LEFT I_LOOK I_TURN_LEFT I_LOOK I_TURN_LEFT I_LOOK I_TURN_LEFT I_LOOK	 turn left turn left run turn left look turn left look turn left look turn left look turn left look turn left look turn left look turn left look turn left look turn left look
jump around left thrice and turn opposite left twice ->	I_TURN_LEFT I_JUMP I_TURN_LEFT I_JUMP I_TURN_LEFT I_JUMP I_TURN_LEFT I_JUMP I_TURN_LEFT I_JUMP I_TURN_LEFT I_JUMP I_TURN_LEFT I_JUMP I_TURN_LEFT I_JUMP I_TURN_LEFT I_JUMP I_TURN_LEFT I_JUMP I_TURN_LEFT I_JUMP I_TURN_LEFT I_JUMP I_TURN_LEFT I_TURN_LEFT I_TURN_LEFT I_TURN_LEFT	 turn left jump turn left jump turn left jump turn left jump turn left jump turn left jump turn left jump turn left jump turn left turn left turn left turn left
jump around right thrice and run around left thrice ->	I_TURN_RIGHT I_JUMP I_TURN_RIGHT I_JUMP I_TURN_RIGHT I_JUMP I_TURN_RIGHT I_JUMP I_TURN_RIGHT I_JUMP I_TURN_RIGHT I_JUMP I_TURN_RIGHT I_JUMP I_TURN_RIGHT I_JUMP I_TURN_RIGHT I_JUMP I_TURN_RIGHT I_JUMP I_TURN_RIGHT I_JUMP I_TURN_RIGHT I_JUMP I_TURN_LEFT I_RUN I_TURN_LEFT I_RUN I_TURN_LEFT I_RUN I_TURN_LEFT I_RUN I_TURN_LEFT I_RUN I_TURN_LEFT I_RUN I_TURN_LEFT I_RUN I_TURN_LEFT I_RUN I_TURN_LEFT I_RUN I_TURN_LEFT I_RUN I_TURN_LEFT I_RUN I_TURN_LEFT I_RUN	 turn right jump turn right jump turn right jump turn right jump turn right jump turn right jump turn right jump turn right jump turn right jump turn left run turn left run turn left run turn left run turn left run turn left run turn left run turn left run
run around left thrice after walk left ->	I_TURN_LEFT I_WALK I_TURN_LEFT I_RUN I_TURN_LEFT I_RUN I_TURN_LEFT I_RUN I_TURN_LEFT I_RUN I_TURN_LEFT I_RUN I_TURN_LEFT I_RUN I_TURN_LEFT I_RUN I_TURN_LEFT I_RUN I_TURN_LEFT I_RUN I_TURN_LEFT I_RUN I_TURN_LEFT I_RUN I_TURN_LEFT I_RUN	 turn left walk turn left run turn left run turn left run turn left run turn left run turn left run turn left run turn left run turn left run turn left run
jump around left thrice and run opposite right thrice ->	I_TURN_LEFT I_JUMP I_TURN_LEFT I_JUMP I_TURN_LEFT I_JUMP I_TURN_LEFT I_JUMP I_TURN_LEFT I_JUMP I_TURN_LEFT I_JUMP I_TURN_LEFT I_JUMP I_TURN_LEFT I_JUMP I_TURN_LEFT I_JUMP I_TURN_LEFT I_JUMP I_TURN_LEFT I_JUMP I_TURN_LEFT I_JUMP I_TURN_RIGHT I_TURN_RIGHT I_RUN I_TURN_RIGHT I_TURN_RIGHT I_RUN I_TURN_RIGHT I_TURN_RIGHT I_RUN	 turn left jump turn left jump turn left jump turn left jump turn left jump turn left jump turn left jump turn left jump turn left jump turn right turn right run turn right turn right run turn right turn right run
walk opposite right twice after jump around left thrice ->	I_TURN_LEFT I_JUMP I_TURN_LEFT I_JUMP I_TURN_LEFT I_JUMP I_TURN_LEFT I_JUMP I_TURN_LEFT I_JUMP I_TURN_LEFT I_JUMP I_TURN_LEFT I_JUMP I_TURN_LEFT I_JUMP I_TURN_LEFT I_JUMP I_TURN_LEFT I_JUMP I_TURN_LEFT I_JUMP I_TURN_LEFT I_JUMP I_TURN_RIGHT I_TURN_RIGHT I_WALK I_TURN_RIGHT I_TURN_RIGHT I_WALK	 turn left jump turn left jump turn left jump turn left jump turn left jump turn left jump turn left jump turn left jump turn right turn right walk turn right turn right walk
look around right thrice after turn opposite right twice ->	I_TURN_RIGHT I_TURN_RIGHT I_TURN_RIGHT I_TURN_RIGHT I_TURN_RIGHT I_LOOK I_TURN_RIGHT I_LOOK I_TURN_RIGHT I_LOOK I_TURN_RIGHT I_LOOK I_TURN_RIGHT I_LOOK I_TURN_RIGHT I_LOOK I_TURN_RIGHT I_LOOK I_TURN_RIGHT I_LOOK I_TURN_RIGHT I_LOOK I_TURN_RIGHT I_LOOK I_TURN_RIGHT I_LOOK I_TURN_RIGHT I_LOOK	 turn right turn right turn right turn right turn right look turn right look turn right look turn right look turn right look turn right look turn right look turn right look turn right look turn right look
look around right thrice and look around left twice ->	I_TURN_RIGHT I_LOOK I_TURN_RIGHT I_LOOK I_TURN_RIGHT I_LOOK I_TURN_RIGHT I_LOOK I_TURN_RIGHT I_LOOK I_TURN_RIGHT I_LOOK I_TURN_RIGHT I_LOOK I_TURN_RIGHT I_LOOK I_TURN_RIGHT I_LOOK I_TURN_RIGHT I_LOOK I_TURN_RIGHT I_LOOK I_TURN_RIGHT I_LOOK I_TURN_LEFT I_LOOK I_TURN_LEFT I_LOOK I_TURN_LEFT I_LOOK I_TURN_LEFT I_LOOK I_TURN_LEFT I_LOOK I_TURN_LEFT I_LOOK I_TURN_LEFT I_LOOK I_TURN_LEFT I_LOOK	 turn right look turn right look turn right look turn right look turn right look turn right look turn right look turn left look turn left look turn left look turn left look turn left look turn left look
run left twice after run around left thrice ->	I_TURN_LEFT I_RUN I_TURN_LEFT I_RUN I_TURN_LEFT I_RUN I_TURN_LEFT I_RUN I_TURN_LEFT I_RUN I_TURN_LEFT I_RUN I_TURN_LEFT I_RUN I_TURN_LEFT I_RUN I_TURN_LEFT I_RUN I_TURN_LEFT I_RUN I_TURN_LEFT I_RUN I_TURN_LEFT I_RUN I_TURN_LEFT I_RUN I_TURN_LEFT I_RUN	 turn left run turn left run turn left run turn left run turn left run turn left run turn left run turn left run turn left run turn left run
look opposite right thrice after walk around right thrice ->	I_TURN_RIGHT I_WALK I_TURN_RIGHT I_WALK I_TURN_RIGHT I_WALK I_TURN_RIGHT I_WALK I_TURN_RIGHT I_WALK I_TURN_RIGHT I_WALK I_TURN_RIGHT I_WALK I_TURN_RIGHT I_WALK I_TURN_RIGHT I_WALK I_TURN_RIGHT I_WALK I_TURN_RIGHT I_WALK I_TURN_RIGHT I_WALK I_TURN_RIGHT I_TURN_RIGHT I_LOOK I_TURN_RIGHT I_TURN_RIGHT I_LOOK I_TURN_RIGHT I_TURN_RIGHT I_LOOK	 turn right walk turn right walk turn right walk turn right walk turn right walk turn right walk turn right walk turn right walk turn right walk turn right turn right look turn right turn right look turn right turn right look
look left after walk around right thrice ->	I_TURN_RIGHT I_WALK I_TURN_RIGHT I_WALK I_TURN_RIGHT I_WALK I_TURN_RIGHT I_WALK I_TURN_RIGHT I_WALK I_TURN_RIGHT I_WALK I_TURN_RIGHT I_WALK I_TURN_RIGHT I_WALK I_TURN_RIGHT I_WALK I_TURN_RIGHT I_WALK I_TURN_RIGHT I_WALK I_TURN_RIGHT I_WALK I_TURN_LEFT I_LOOK	 turn right walk turn right walk turn right walk turn right walk turn right walk turn right walk turn right walk turn right walk turn right walk turn left look
run around right thrice and run around right twice ->	I_TURN_RIGHT I_RUN I_TURN_RIGHT I_RUN I_TURN_RIGHT I_RUN I_TURN_RIGHT I_RUN I_TURN_RIGHT I_RUN I_TURN_RIGHT I_RUN I_TURN_RIGHT I_RUN I_TURN_RIGHT I_RUN I_TURN_RIGHT I_RUN I_TURN_RIGHT I_RUN I_TURN_RIGHT I_RUN I_TURN_RIGHT I_RUN I_TURN_RIGHT I_RUN I_TURN_RIGHT I_RUN I_TURN_RIGHT I_RUN I_TURN_RIGHT I_RUN I_TURN_RIGHT I_RUN I_TURN_RIGHT I_RUN I_TURN_RIGHT I_RUN I_TURN_RIGHT I_RUN	 turn right run turn right run turn right run turn right run turn right run turn right run turn right run turn right run turn right run turn right run turn right run turn right run turn right run turn right run
jump around left twice after walk opposite left thrice ->	I_TURN_LEFT I_TURN_LEFT I_WALK I_TURN_LEFT I_TURN_LEFT I_WALK I_TURN_LEFT I_TURN_LEFT I_WALK I_TURN_LEFT I_JUMP I_TURN_LEFT I_JUMP I_TURN_LEFT I_JUMP I_TURN_LEFT I_JUMP I_TURN_LEFT I_JUMP I_TURN_LEFT I_JUMP I_TURN_LEFT I_JUMP I_TURN_LEFT I_JUMP	 turn left turn left walk turn left turn left walk turn left turn left walk turn left jump turn left jump turn left jump turn left jump turn left jump turn left jump turn left jump turn left jump
run around left twice and jump around right twice ->	I_TURN_LEFT I_RUN I_TURN_LEFT I_RUN I_TURN_LEFT I_RUN I_TURN_LEFT I_RUN I_TURN_LEFT I_RUN I_TURN_LEFT I_RUN I_TURN_LEFT I_RUN I_TURN_LEFT I_RUN I_TURN_RIGHT I_JUMP I_TURN_RIGHT I_JUMP I_TURN_RIGHT I_JUMP I_TURN_RIGHT I_JUMP I_TURN_RIGHT I_JUMP I_TURN_RIGHT I_JUMP I_TURN_RIGHT I_JUMP I_TURN_RIGHT I_JUMP	 turn left run turn left run turn left run turn left run turn left run turn left run turn left run turn left run turn right jump turn right jump turn right jump turn right jump turn right jump turn right jump turn right jump
run around right thrice and walk ->	I_TURN_RIGHT I_RUN I_TURN_RIGHT I_RUN I_TURN_RIGHT I_RUN I_TURN_RIGHT I_RUN I_TURN_RIGHT I_RUN I_TURN_RIGHT I_RUN I_TURN_RIGHT I_RUN I_TURN_RIGHT I_RUN I_TURN_RIGHT I_RUN I_TURN_RIGHT I_RUN I_TURN_RIGHT I_RUN I_TURN_RIGHT I_RUN I_WALK	 turn right run turn right run turn right run turn right run turn right run turn right run turn right run turn right run turn right run turn right run walk
look around left thrice and turn right thrice ->	I_TURN_LEFT I_LOOK I_TURN_LEFT I_LOOK I_TURN_LEFT I_LOOK I_TURN_LEFT I_LOOK I_TURN_LEFT I_LOOK I_TURN_LEFT I_LOOK I_TURN_LEFT I_LOOK I_TURN_LEFT I_LOOK I_TURN_LEFT I_LOOK I_TURN_LEFT I_LOOK I_TURN_LEFT I_LOOK I_TURN_LEFT I_LOOK I_TURN_RIGHT I_TURN_RIGHT I_TURN_RIGHT	 turn left look turn left look turn left look turn left look turn left look turn left look turn left look turn left look turn left look turn right turn right turn right
run around right thrice and run left twice ->	I_TURN_RIGHT I_RUN I_TURN_RIGHT I_RUN I_TURN_RIGHT I_RUN I_TURN_RIGHT I_RUN I_TURN_RIGHT I_RUN I_TURN_RIGHT I_RUN I_TURN_RIGHT I_RUN I_TURN_RIGHT I_RUN I_TURN_RIGHT I_RUN I_TURN_RIGHT I_RUN I_TURN_RIGHT I_RUN I_TURN_RIGHT I_RUN I_TURN_LEFT I_RUN I_TURN_LEFT I_RUN	 turn right run turn right run turn right run turn right run turn right run turn right run turn right run turn right run turn left run turn left run
turn right twice and run around right thrice ->	I_TURN_RIGHT I_TURN_RIGHT I_TURN_RIGHT I_RUN I_TURN_RIGHT I_RUN I_TURN_RIGHT I_RUN I_TURN_RIGHT I_RUN I_TURN_RIGHT I_RUN I_TURN_RIGHT I_RUN I_TURN_RIGHT I_RUN I_TURN_RIGHT I_RUN I_TURN_RIGHT I_RUN I_TURN_RIGHT I_RUN I_TURN_RIGHT I_RUN I_TURN_RIGHT I_RUN	 turn right turn right turn right run turn right run turn right run turn right run turn right run turn right run turn right run turn right run turn right run
look right thrice and run around right thrice ->	I_TURN_RIGHT I_LOOK I_TURN_RIGHT I_LOOK I_TURN_RIGHT I_LOOK I_TURN_RIGHT I_RUN I_TURN_RIGHT I_RUN I_TURN_RIGHT I_RUN I_TURN_RIGHT I_RUN I_TURN_RIGHT I_RUN I_TURN_RIGHT I_RUN I_TURN_RIGHT I_RUN I_TURN_RIGHT I_RUN I_TURN_RIGHT I_RUN I_TURN_RIGHT I_RUN I_TURN_RIGHT I_RUN I_TURN_RIGHT I_RUN	 turn right look turn right look turn right look turn right run turn right run turn right run turn right run turn right run turn right run turn right run turn right run turn right run
look around right thrice after turn around right ->	I_TURN_RIGHT I_TURN_RIGHT I_TURN_RIGHT I_TURN_RIGHT I_TURN_RIGHT I_LOOK I_TURN_RIGHT I_LOOK I_TURN_RIGHT I_LOOK I_TURN_RIGHT I_LOOK I_TURN_RIGHT I_LOOK I_TURN_RIGHT I_LOOK I_TURN_RIGHT I_LOOK I_TURN_RIGHT I_LOOK I_TURN_RIGHT I_LOOK I_TURN_RIGHT I_LOOK I_TURN_RIGHT I_LOOK I_TURN_RIGHT I_LOOK	 turn right turn right turn right turn right turn right look turn right look turn right look turn right look turn right look turn right look turn right look turn right look turn right look
jump and jump around left thrice ->	I_JUMP I_TURN_LEFT I_JUMP I_TURN_LEFT I_JUMP I_TURN_LEFT I_JUMP I_TURN_LEFT I_JUMP I_TURN_LEFT I_JUMP I_TURN_LEFT I_JUMP I_TURN_LEFT I_JUMP I_TURN_LEFT I_JUMP I_TURN_LEFT I_JUMP I_TURN_LEFT I_JUMP I_TURN_LEFT I_JUMP I_TURN_LEFT I_JUMP	 jump turn left jump turn left jump turn left jump turn left jump turn left jump turn left jump turn left jump turn left jump turn left jump
run around right twice and look opposite right thrice ->	I_TURN_RIGHT I_RUN I_TURN_RIGHT I_RUN I_TURN_RIGHT I_RUN I_TURN_RIGHT I_RUN I_TURN_RIGHT I_RUN I_TURN_RIGHT I_RUN I_TURN_RIGHT I_RUN I_TURN_RIGHT I_RUN I_TURN_RIGHT I_TURN_RIGHT I_LOOK I_TURN_RIGHT I_TURN_RIGHT I_LOOK I_TURN_RIGHT I_TURN_RIGHT I_LOOK	 turn right run turn right run turn right run turn right run turn right run turn right run turn right run turn right turn right look turn right turn right look turn right turn right look
jump around right twice after look opposite right thrice ->	I_TURN_RIGHT I_TURN_RIGHT I_LOOK I_TURN_RIGHT I_TURN_RIGHT I_LOOK I_TURN_RIGHT I_TURN_RIGHT I_LOOK I_TURN_RIGHT I_JUMP I_TURN_RIGHT I_JUMP I_TURN_RIGHT I_JUMP I_TURN_RIGHT I_JUMP I_TURN_RIGHT I_JUMP I_TURN_RIGHT I_JUMP I_TURN_RIGHT I_JUMP I_TURN_RIGHT I_JUMP	 turn right turn right look turn right turn right look turn right turn right look turn right jump turn right jump turn right jump turn right jump turn right jump turn right jump turn right jump turn right jump
run around right twice and jump around right ->	I_TURN_RIGHT I_RUN I_TURN_RIGHT I_RUN I_TURN_RIGHT I_RUN I_TURN_RIGHT I_RUN I_TURN_RIGHT I_RUN I_TURN_RIGHT I_RUN I_TURN_RIGHT I_RUN I_TURN_RIGHT I_RUN I_TURN_RIGHT I_JUMP I_TURN_RIGHT I_JUMP I_TURN_RIGHT I_JUMP I_TURN_RIGHT I_JUMP	 turn right run turn right run turn right run turn right run turn right run turn right run turn right run turn right run turn right jump turn right jump turn right jump
run around right thrice and run opposite right ->	I_TURN_RIGHT I_RUN I_TURN_RIGHT I_RUN I_TURN_RIGHT I_RUN I_TURN_RIGHT I_RUN I_TURN_RIGHT I_RUN I_TURN_RIGHT I_RUN I_TURN_RIGHT I_RUN I_TURN_RIGHT I_RUN I_TURN_RIGHT I_RUN I_TURN_RIGHT I_RUN I_TURN_RIGHT I_RUN I_TURN_RIGHT I_RUN I_TURN_RIGHT I_TURN_RIGHT I_RUN	 turn right run turn right run turn right run turn right run turn right run turn right run turn right run turn right run turn right run turn right turn right run
walk around right thrice after walk left ->	I_TURN_LEFT I_WALK I_TURN_RIGHT I_WALK I_TURN_RIGHT I_WALK I_TURN_RIGHT I_WALK I_TURN_RIGHT I_WALK I_TURN_RIGHT I_WALK I_TURN_RIGHT I_WALK I_TURN_RIGHT I_WALK I_TURN_RIGHT I_WALK I_TURN_RIGHT I_WALK I_TURN_RIGHT I_WALK I_TURN_RIGHT I_WALK I_TURN_RIGHT I_WALK	 turn left walk turn right walk turn right walk turn right walk turn right walk turn right walk turn right walk turn right walk turn right walk turn right walk
walk around left thrice and turn opposite left twice ->	I_TURN_LEFT I_WALK I_TURN_LEFT I_WALK I_TURN_LEFT I_WALK I_TURN_LEFT I_WALK I_TURN_LEFT I_WALK I_TURN_LEFT I_WALK I_TURN_LEFT I_WALK I_TURN_LEFT I_WALK I_TURN_LEFT I_WALK I_TURN_LEFT I_WALK I_TURN_LEFT I_WALK I_TURN_LEFT I_WALK I_TURN_LEFT I_TURN_LEFT I_TURN_LEFT I_TURN_LEFT	 turn left walk turn left walk turn left walk turn left walk turn left walk turn left walk turn left walk turn left walk turn left turn left turn left turn left
jump around right after look around right thrice ->	I_TURN_RIGHT I_LOOK I_TURN_RIGHT I_LOOK I_TURN_RIGHT I_LOOK I_TURN_RIGHT I_LOOK I_TURN_RIGHT I_LOOK I_TURN_RIGHT I_LOOK I_TURN_RIGHT I_LOOK I_TURN_RIGHT I_LOOK I_TURN_RIGHT I_LOOK I_TURN_RIGHT I_LOOK I_TURN_RIGHT I_LOOK I_TURN_RIGHT I_LOOK I_TURN_RIGHT I_JUMP I_TURN_RIGHT I_JUMP I_TURN_RIGHT I_JUMP I_TURN_RIGHT I_JUMP	 turn right look turn right look turn right look turn right look turn right look turn right look turn right look turn right look turn right look turn right jump turn right jump turn right jump turn right jump
look around right thrice and walk opposite left ->	I_TURN_RIGHT I_LOOK I_TURN_RIGHT I_LOOK I_TURN_RIGHT I_LOOK I_TURN_RIGHT I_LOOK I_TURN_RIGHT I_LOOK I_TURN_RIGHT I_LOOK I_TURN_RIGHT I_LOOK I_TURN_RIGHT I_LOOK I_TURN_RIGHT I_LOOK I_TURN_RIGHT I_LOOK I_TURN_RIGHT I_LOOK I_TURN_RIGHT I_LOOK I_TURN_LEFT I_TURN_LEFT I_WALK	 turn right look turn right look turn right look turn right look turn right look turn right look turn right look turn right look turn right look turn left turn left walk
turn left thrice after jump around left thrice ->	I_TURN_LEFT I_JUMP I_TURN_LEFT I_JUMP I_TURN_LEFT I_JUMP I_TURN_LEFT I_JUMP I_TURN_LEFT I_JUMP I_TURN_LEFT I_JUMP I_TURN_LEFT I_JUMP I_TURN_LEFT I_JUMP I_TURN_LEFT I_JUMP I_TURN_LEFT I_JUMP I_TURN_LEFT I_JUMP I_TURN_LEFT I_JUMP I_TURN_LEFT I_TURN_LEFT I_TURN_LEFT	 turn left jump turn left jump turn left jump turn left jump turn left jump turn left jump turn left jump turn left jump turn left jump turn left jump turn left turn left turn left
turn left twice and jump around right thrice ->	I_TURN_LEFT I_TURN_LEFT I_TURN_RIGHT I_JUMP I_TURN_RIGHT I_JUMP I_TURN_RIGHT I_JUMP I_TURN_RIGHT I_JUMP I_TURN_RIGHT I_JUMP I_TURN_RIGHT I_JUMP I_TURN_RIGHT I_JUMP I_TURN_RIGHT I_JUMP I_TURN_RIGHT I_JUMP I_TURN_RIGHT I_JUMP I_TURN_RIGHT I_JUMP I_TURN_RIGHT I_JUMP	 turn left turn left turn right jump turn right jump turn right jump turn right jump turn right jump turn right jump turn right jump turn right jump
turn opposite left twice after walk around left thrice ->	I_TURN_LEFT I_WALK I_TURN_LEFT I_WALK I_TURN_LEFT I_WALK I_TURN_LEFT I_WALK I_TURN_LEFT I_WALK I_TURN_LEFT I_WALK I_TURN_LEFT I_WALK I_TURN_LEFT I_WALK I_TURN_LEFT I_WALK I_TURN_LEFT I_WALK I_TURN_LEFT I_WALK I_TURN_LEFT I_WALK I_TURN_LEFT I_TURN_LEFT I_TURN_LEFT I_TURN_LEFT	 turn left walk turn left walk turn left walk turn left walk turn left walk turn left walk turn left walk turn left walk turn left turn left turn left turn left
run around left thrice after jump around right ->	I_TURN_RIGHT I_JUMP I_TURN_RIGHT I_JUMP I_TURN_RIGHT I_JUMP I_TURN_RIGHT I_JUMP I_TURN_LEFT I_RUN I_TURN_LEFT I_RUN I_TURN_LEFT I_RUN I_TURN_LEFT I_RUN I_TURN_LEFT I_RUN I_TURN_LEFT I_RUN I_TURN_LEFT I_RUN I_TURN_LEFT I_RUN I_TURN_LEFT I_RUN I_TURN_LEFT I_RUN I_TURN_LEFT I_RUN I_TURN_LEFT I_RUN	 turn right jump turn right jump turn right jump turn left run turn left run turn left run turn left run turn left run turn left run turn left run turn left run turn left run turn left run
walk around left twice after run around left ->	I_TURN_LEFT I_RUN I_TURN_LEFT I_RUN I_TURN_LEFT I_RUN I_TURN_LEFT I_RUN I_TURN_LEFT I_WALK I_TURN_LEFT I_WALK I_TURN_LEFT I_WALK I_TURN_LEFT I_WALK I_TURN_LEFT I_WALK I_TURN_LEFT I_WALK I_TURN_LEFT I_WALK I_TURN_LEFT I_WALK	 turn left run turn left run turn left run turn left run turn left walk turn left walk turn left walk turn left walk turn left walk turn left walk turn left walk
run around left twice after look around right twice ->	I_TURN_RIGHT I_LOOK I_TURN_RIGHT I_LOOK I_TURN_RIGHT I_LOOK I_TURN_RIGHT I_LOOK I_TURN_RIGHT I_LOOK I_TURN_RIGHT I_LOOK I_TURN_RIGHT I_LOOK I_TURN_RIGHT I_LOOK I_TURN_LEFT I_RUN I_TURN_LEFT I_RUN I_TURN_LEFT I_RUN I_TURN_LEFT I_RUN I_TURN_LEFT I_RUN I_TURN_LEFT I_RUN I_TURN_LEFT I_RUN I_TURN_LEFT I_RUN	 turn right look turn right look turn right look turn right look turn right look turn right look turn right look turn right look turn left run turn left run turn left run turn left run turn left run turn left run turn left run turn left run
walk opposite left and look around right thrice ->	I_TURN_LEFT I_TURN_LEFT I_WALK I_TURN_RIGHT I_LOOK I_TURN_RIGHT I_LOOK I_TURN_RIGHT I_LOOK I_TURN_RIGHT I_LOOK I_TURN_RIGHT I_LOOK I_TURN_RIGHT I_LOOK I_TURN_RIGHT I_LOOK I_TURN_RIGHT I_LOOK I_TURN_RIGHT I_LOOK I_TURN_RIGHT I_LOOK I_TURN_RIGHT I_LOOK I_TURN_RIGHT I_LOOK	 turn left turn left walk turn right look turn right look turn right look turn right look turn right look turn right look turn right look turn right look turn right look turn right look
run around right thrice after walk right ->	I_TURN_RIGHT I_WALK I_TURN_RIGHT I_RUN I_TURN_RIGHT I_RUN I_TURN_RIGHT I_RUN I_TURN_RIGHT I_RUN I_TURN_RIGHT I_RUN I_TURN_RIGHT I_RUN I_TURN_RIGHT I_RUN I_TURN_RIGHT I_RUN I_TURN_RIGHT I_RUN I_TURN_RIGHT I_RUN I_TURN_RIGHT I_RUN I_TURN_RIGHT I_RUN	 turn right walk turn right run turn right run turn right run turn right run turn right run turn right run turn right run turn right run turn right run
run around right thrice and turn opposite right thrice ->	I_TURN_RIGHT I_RUN I_TURN_RIGHT I_RUN I_TURN_RIGHT I_RUN I_TURN_RIGHT I_RUN I_TURN_RIGHT I_RUN I_TURN_RIGHT I_RUN I_TURN_RIGHT I_RUN I_TURN_RIGHT I_RUN I_TURN_RIGHT I_RUN I_TURN_RIGHT I_RUN I_TURN_RIGHT I_RUN I_TURN_RIGHT I_RUN I_TURN_RIGHT I_TURN_RIGHT I_TURN_RIGHT I_TURN_RIGHT I_TURN_RIGHT I_TURN_RIGHT	 turn right run turn right run turn right run turn right run turn right run turn right run turn right run turn right run turn right turn right turn right turn right turn right turn right turn right
walk around right twice and walk around left twice ->	I_TURN_RIGHT I_WALK I_TURN_RIGHT I_WALK I_TURN_RIGHT I_WALK I_TURN_RIGHT I_WALK I_TURN_RIGHT I_WALK I_TURN_RIGHT I_WALK I_TURN_RIGHT I_WALK I_TURN_RIGHT I_WALK I_TURN_LEFT I_WALK I_TURN_LEFT I_WALK I_TURN_LEFT I_WALK I_TURN_LEFT I_WALK I_TURN_LEFT I_WALK I_TURN_LEFT I_WALK I_TURN_LEFT I_WALK I_TURN_LEFT I_WALK	 turn right walk turn right walk turn right walk turn right walk turn right walk turn right walk turn right walk turn right walk turn left walk turn left walk turn left walk turn left walk turn left walk
look around right after jump around right thrice ->	I_TURN_RIGHT I_JUMP I_TURN_RIGHT I_JUMP I_TURN_RIGHT I_JUMP I_TURN_RIGHT I_JUMP I_TURN_RIGHT I_JUMP I_TURN_RIGHT I_JUMP I_TURN_RIGHT I_JUMP I_TURN_RIGHT I_JUMP I_TURN_RIGHT I_JUMP I_TURN_RIGHT I_JUMP I_TURN_RIGHT I_JUMP I_TURN_RIGHT I_JUMP I_TURN_RIGHT I_LOOK I_TURN_RIGHT I_LOOK I_TURN_RIGHT I_LOOK I_TURN_RIGHT I_LOOK	 turn right jump turn right jump turn right jump turn right jump turn right jump turn right jump turn right jump turn right jump turn right look turn right look turn right look turn right look
jump opposite left twice after run around left thrice ->	I_TURN_LEFT I_RUN I_TURN_LEFT I_RUN I_TURN_LEFT I_RUN I_TURN_LEFT I_RUN I_TURN_LEFT I_RUN I_TURN_LEFT I_RUN I_TURN_LEFT I_RUN I_TURN_LEFT I_RUN I_TURN_LEFT I_RUN I_TURN_LEFT I_RUN I_TURN_LEFT I_RUN I_TURN_LEFT I_RUN I_TURN_LEFT I_TURN_LEFT I_JUMP I_TURN_LEFT I_TURN_LEFT I_JUMP	 turn left run turn left run turn left run turn left run turn left run turn left run turn left run turn left run turn left run turn left turn left jump turn left turn left jump
run after run around right thrice ->	I_TURN_RIGHT I_RUN I_TURN_RIGHT I_RUN I_TURN_RIGHT I_RUN I_TURN_RIGHT I_RUN I_TURN_RIGHT I_RUN I_TURN_RIGHT I_RUN I_TURN_RIGHT I_RUN I_TURN_RIGHT I_RUN I_TURN_RIGHT I_RUN I_TURN_RIGHT I_RUN I_TURN_RIGHT I_RUN I_TURN_RIGHT I_RUN I_RUN	 turn right run turn right run turn right run turn right run turn right run turn right run turn right run turn right run turn right run
look twice and look around left thrice ->	I_LOOK I_LOOK I_TURN_LEFT I_LOOK I_TURN_LEFT I_LOOK I_TURN_LEFT I_LOOK I_TURN_LEFT I_LOOK I_TURN_LEFT I_LOOK I_TURN_LEFT I_LOOK I_TURN_LEFT I_LOOK I_TURN_LEFT I_LOOK I_TURN_LEFT I_LOOK I_TURN_LEFT I_LOOK I_TURN_LEFT I_LOOK I_TURN_LEFT I_LOOK	 look look look turn left look turn left look turn left look turn left look turn left look turn left look turn left look turn left look turn left look
look opposite right thrice after run around left twice ->	I_TURN_LEFT I_RUN I_TURN_LEFT I_RUN I_TURN_LEFT I_RUN I_TURN_LEFT I_RUN I_TURN_LEFT I_RUN I_TURN_LEFT I_RUN I_TURN_LEFT I_RUN I_TURN_LEFT I_RUN I_TURN_RIGHT I_TURN_RIGHT I_LOOK I_TURN_RIGHT I_TURN_RIGHT I_LOOK I_TURN_RIGHT I_TURN_RIGHT I_LOOK	 turn left run turn left run turn left run turn left run turn left run turn left run turn left run turn left run turn right turn right look turn right turn right look turn right turn right look
jump around left twice and look around left twice ->	I_TURN_LEFT I_JUMP I_TURN_LEFT I_JUMP I_TURN_LEFT I_JUMP I_TURN_LEFT I_JUMP I_TURN_LEFT I_JUMP I_TURN_LEFT I_JUMP I_TURN_LEFT I_JUMP I_TURN_LEFT I_JUMP I_TURN_LEFT I_LOOK I_TURN_LEFT I_LOOK I_TURN_LEFT I_LOOK I_TURN_LEFT I_LOOK I_TURN_LEFT I_LOOK I_TURN_LEFT I_LOOK I_TURN_LEFT I_LOOK I_TURN_LEFT I_LOOK	 turn left jump turn left jump turn left jump turn left jump turn left jump turn left jump turn left jump turn left jump turn left look turn left look turn left look turn left look turn left look turn left look turn left look
jump opposite right twice after walk around left thrice ->	I_TURN_LEFT I_WALK I_TURN_LEFT I_WALK I_TURN_LEFT I_WALK I_TURN_LEFT I_WALK I_TURN_LEFT I_WALK I_TURN_LEFT I_WALK I_TURN_LEFT I_WALK I_TURN_LEFT I_WALK I_TURN_LEFT I_WALK I_TURN_LEFT I_WALK I_TURN_LEFT I_WALK I_TURN_LEFT I_WALK I_TURN_RIGHT I_TURN_RIGHT I_JUMP I_TURN_RIGHT I_TURN_RIGHT I_JUMP	 turn left walk turn left walk turn left walk turn left walk turn left walk turn left walk turn left walk turn left walk turn right turn right jump turn right turn right jump
look around right thrice after run twice ->	I_RUN I_RUN I_TURN_RIGHT I_LOOK I_TURN_RIGHT I_LOOK I_TURN_RIGHT I_LOOK I_TURN_RIGHT I_LOOK I_TURN_RIGHT I_LOOK I_TURN_RIGHT I_LOOK I_TURN_RIGHT I_LOOK I_TURN_RIGHT I_LOOK I_TURN_RIGHT I_LOOK I_TURN_RIGHT I_LOOK I_TURN_RIGHT I_LOOK I_TURN_RIGHT I_LOOK	 run run turn right look turn right look turn right look turn right look turn right look turn right look turn right look turn right look turn right look
walk after run around right thrice ->	I_TURN_RIGHT I_RUN I_TURN_RIGHT I_RUN I_TURN_RIGHT I_RUN I_TURN_RIGHT I_RUN I_TURN_RIGHT I_RUN I_TURN_RIGHT I_RUN I_TURN_RIGHT I_RUN I_TURN_RIGHT I_RUN I_TURN_RIGHT I_RUN I_TURN_RIGHT I_RUN I_TURN_RIGHT I_RUN I_TURN_RIGHT I_RUN I_WALK	 turn right run turn right run turn right run turn right run turn right run turn right run turn right run turn right run turn right run walk
turn opposite right thrice and jump around right thrice ->	I_TURN_RIGHT I_TURN_RIGHT I_TURN_RIGHT I_TURN_RIGHT I_TURN_RIGHT I_TURN_RIGHT I_TURN_RIGHT I_JUMP I_TURN_RIGHT I_JUMP I_TURN_RIGHT I_JUMP I_TURN_RIGHT I_JUMP I_TURN_RIGHT I_JUMP I_TURN_RIGHT I_JUMP I_TURN_RIGHT I_JUMP I_TURN_RIGHT I_JUMP I_TURN_RIGHT I_JUMP I_TURN_RIGHT I_JUMP I_TURN_RIGHT I_JUMP I_TURN_RIGHT I_JUMP	 turn right turn right turn right turn right turn right turn right turn right jump turn right jump turn right jump turn right jump turn right jump turn right jump turn right jump turn right jump
run left and jump around left thrice ->	I_TURN_LEFT I_RUN I_TURN_LEFT I_JUMP I_TURN_LEFT I_JUMP I_TURN_LEFT I_JUMP I_TURN_LEFT I_JUMP I_TURN_LEFT I_JUMP I_TURN_LEFT I_JUMP I_TURN_LEFT I_JUMP I_TURN_LEFT I_JUMP I_TURN_LEFT I_JUMP I_TURN_LEFT I_JUMP I_TURN_LEFT I_JUMP I_TURN_LEFT I_JUMP	 turn left run turn left jump turn left jump turn left jump turn left jump turn left jump turn left jump turn left jump turn left jump turn left jump
jump around right and run around right twice ->	I_TURN_RIGHT I_JUMP I_TURN_RIGHT I_JUMP I_TURN_RIGHT I_JUMP I_TURN_RIGHT I_JUMP I_TURN_RIGHT I_RUN I_TURN_RIGHT I_RUN I_TURN_RIGHT I_RUN I_TURN_RIGHT I_RUN I_TURN_RIGHT I_RUN I_TURN_RIGHT I_RUN I_TURN_RIGHT I_RUN I_TURN_RIGHT I_RUN	 turn right jump turn right jump turn right jump turn right jump turn right jump turn right run turn right run turn right run turn right run turn right run turn right run turn right run turn right run
walk around left thrice and jump right ->	I_TURN_LEFT I_WALK I_TURN_LEFT I_WALK I_TURN_LEFT I_WALK I_TURN_LEFT I_WALK I_TURN_LEFT I_WALK I_TURN_LEFT I_WALK I_TURN_LEFT I_WALK I_TURN_LEFT I_WALK I_TURN_LEFT I_WALK I_TURN_LEFT I_WALK I_TURN_LEFT I_WALK I_TURN_LEFT I_WALK I_TURN_RIGHT I_JUMP	 turn left walk turn left walk turn left walk turn left walk turn left walk turn left walk turn left walk turn left walk turn left walk turn right jump
walk around right twice after walk around right twice ->	I_TURN_RIGHT I_WALK I_TURN_RIGHT I_WALK I_TURN_RIGHT I_WALK I_TURN_RIGHT I_WALK I_TURN_RIGHT I_WALK I_TURN_RIGHT I_WALK I_TURN_RIGHT I_WALK I_TURN_RIGHT I_WALK I_TURN_RIGHT I_WALK I_TURN_RIGHT I_WALK I_TURN_RIGHT I_WALK I_TURN_RIGHT I_WALK I_TURN_RIGHT I_WALK I_TURN_RIGHT I_WALK I_TURN_RIGHT I_WALK I_TURN_RIGHT I_WALK	 turn right walk turn right walk turn right walk turn right walk turn right walk turn right walk turn right walk turn right walk turn right walk turn right walk turn right walk turn right walk turn right walk
run around right thrice and jump opposite left twice ->	I_TURN_RIGHT I_RUN I_TURN_RIGHT I_RUN I_TURN_RIGHT I_RUN I_TURN_RIGHT I_RUN I_TURN_RIGHT I_RUN I_TURN_RIGHT I_RUN I_TURN_RIGHT I_RUN I_TURN_RIGHT I_RUN I_TURN_RIGHT I_RUN I_TURN_RIGHT I_RUN I_TURN_RIGHT I_RUN I_TURN_RIGHT I_RUN I_TURN_LEFT I_TURN_LEFT I_JUMP I_TURN_LEFT I_TURN_LEFT I_JUMP	 turn right run turn right run turn right run turn right run turn right run turn right run turn right run turn right run turn left turn left jump turn left turn left jump
look opposite right thrice and jump around left twice ->	I_TURN_RIGHT I_TURN_RIGHT I_LOOK I_TURN_RIGHT I_TURN_RIGHT I_LOOK I_TURN_RIGHT I_TURN_RIGHT I_LOOK I_TURN_LEFT I_JUMP I_TURN_LEFT I_JUMP I_TURN_LEFT I_JUMP I_TURN_LEFT I_JUMP I_TURN_LEFT I_JUMP I_TURN_LEFT I_JUMP I_TURN_LEFT I_JUMP I_TURN_LEFT I_JUMP	 turn right turn right look turn right turn right look turn right turn right look turn left jump turn left jump turn left jump turn left jump turn left jump turn left jump turn left jump turn left jump
jump opposite left and jump around left thrice ->	I_TURN_LEFT I_TURN_LEFT I_JUMP I_TURN_LEFT I_JUMP I_TURN_LEFT I_JUMP I_TURN_LEFT I_JUMP I_TURN_LEFT I_JUMP I_TURN_LEFT I_JUMP I_TURN_LEFT I_JUMP I_TURN_LEFT I_JUMP I_TURN_LEFT I_JUMP I_TURN_LEFT I_JUMP I_TURN_LEFT I_JUMP I_TURN_LEFT I_JUMP I_TURN_LEFT I_JUMP	 turn left turn left jump turn left jump turn left jump turn left jump turn left jump turn left jump turn left jump turn left jump turn left jump turn left jump turn left jump
